STATE/UT,DISTRICT,Year,Rape,Kidnapping and Abduction,Dowry Deaths,Assault on women with intent to outrage her modesty,Insult to modesty of Women,Cruelty by Husband or his Relatives,Total crimes
ANDHRA PRADESH,ADILABAD,2008,50,26,5,174,103,355,713
ANDHRA PRADESH,ANANTAPUR,2008,37,36,12,133,132,0,350
ANDHRA PRADESH,CHITTOOR,2008,30,57,26,104,250,288,755
ANDHRA PRADESH,CUDDAPAH,2008,27,64,11,212,37,267,618
ANDHRA PRADESH,CYBERABAD,2008,80,101,59,130,833,884,2087
ANDHRA PRADESH,EAST GODAVARI,2008,48,13,23,194,131,563,972
ANDHRA PRADESH,GUNTAKAL RLY.,2008,0,0,0,3,1,2,6
ANDHRA PRADESH,GUNTUR,2008,48,65,26,306,99,496,1040
ANDHRA PRADESH,HYDERABAD CITY,2008,62,77,41,231,148,1184,1743
ANDHRA PRADESH,KARIMNAGAR,2008,84,148,48,310,273,596,1459
ANDHRA PRADESH,KHAMMAM,2008,70,83,26,213,24,329,745
ANDHRA PRADESH,KRISHNA,2008,38,52,12,254,93,379,828
ANDHRA PRADESH,KURNOOL,2008,47,72,17,419,232,227,1014
ANDHRA PRADESH,MAHABOOBNAGAR,2008,72,87,35,162,38,231,625
ANDHRA PRADESH,MEDAK,2008,50,44,35,114,61,332,636
ANDHRA PRADESH,NALGONDA,2008,90,76,32,243,155,353,949
ANDHRA PRADESH,NELLORE,2008,39,73,6,184,130,333,765
ANDHRA PRADESH,NIZAMABAD,2008,31,25,16,70,85,305,532
ANDHRA PRADESH,PRAKASHAM,2008,30,53,5,192,38,229,547
ANDHRA PRADESH,RANGA REDDY,2008,37,13,19,39,25,120,253
ANDHRA PRADESH,SECUNDERABAD RLY.,2008,2,0,0,1,0,0,3
ANDHRA PRADESH,SRIKAKULAM,2008,32,14,6,92,72,314,530
ANDHRA PRADESH,VIJAYAWADA CITY,2008,30,36,9,104,252,395,826
ANDHRA PRADESH,VIJAYAWADA RLY.,2008,0,0,0,1,1,0,2
ANDHRA PRADESH,VISAKHA RURAL,2008,12,9,10,79,40,168,318
ANDHRA PRADESH,VISAKHAPATNAM,2008,29,26,13,87,2,488,645
ANDHRA PRADESH,VIZIANAGARAM,2008,6,14,3,88,60,253,424
ANDHRA PRADESH,WARANGAL,2008,59,62,36,223,54,519,953
ANDHRA PRADESH,WEST GODAVARI,2008,117,70,25,368,182,696,1458
ANDHRA PRADESH,TOTAL,2008,1257,1396,556,4730,3551,10306,21796
ARUNACHAL PRADESH,CHANGLANG,2008,2,4,0,5,0,0,11
ARUNACHAL PRADESH,DIBANG VALLEY,2008,3,4,0,9,0,2,18
ARUNACHAL PRADESH,K/KUMEY,2008,2,2,0,2,0,1,7
ARUNACHAL PRADESH,KAMENG EAST,2008,5,4,0,0,0,0,9
ARUNACHAL PRADESH,KAMENG WEST,2008,0,2,0,4,0,0,6
ARUNACHAL PRADESH,LOHIT,2008,3,1,0,1,0,0,5
ARUNACHAL PRADESH,PAPUM PARE,2008,7,10,0,12,1,3,33
ARUNACHAL PRADESH,SIANG EAST,2008,5,5,0,6,0,1,17
ARUNACHAL PRADESH,SIANG UPPER,2008,0,1,0,1,0,0,2
ARUNACHAL PRADESH,SIANG WEST,2008,13,8,0,6,0,5,32
ARUNACHAL PRADESH,SUBANSIRI LOWER,2008,0,3,0,10,0,0,13
ARUNACHAL PRADESH,SUBANSIRI UPPER,2008,2,1,0,6,0,1,10
ARUNACHAL PRADESH,TAWANG,2008,0,0,0,5,0,0,5
ARUNACHAL PRADESH,TIRAP,2008,0,2,0,5,0,0,7
ARUNACHAL PRADESH,UPPER DIBANG VALLEY,2008,0,0,0,0,0,0,0
ARUNACHAL PRADESH,TOTAL,2008,42,47,0,72,1,13,175
ASSAM,BARPETA,2008,97,117,14,34,0,240,502
ASSAM,BASKA,2008,23,30,4,16,0,13,86
ASSAM,BONGAIGAON,2008,51,35,5,13,0,106,210
ASSAM,C.I.D.,2008,0,0,0,0,0,0,0
ASSAM,CACHAR,2008,72,106,13,19,0,216,426
ASSAM,CHIRANG,2008,25,24,0,15,0,38,102
ASSAM,DARRANG,2008,57,57,2,162,2,119,399
ASSAM,DHEMAJI,2008,88,51,0,40,0,165,344
ASSAM,DHUBRI,2008,116,126,4,88,0,393,727
ASSAM,DIBRUGARH,2008,46,60,4,60,0,100,270
ASSAM,G.R.P.,2008,5,8,0,2,0,0,15
ASSAM,GOALPARA,2008,66,64,4,32,0,117,283
ASSAM,GOLAGHAT,2008,42,50,0,46,0,86,224
ASSAM,GUWAHATI CITY,2008,59,97,5,169,0,216,546
ASSAM,HAILAKANDI,2008,39,52,3,8,0,62,164
ASSAM,JORHAT,2008,44,41,0,59,0,76,220
ASSAM,KAMRUP,2008,36,78,3,75,0,101,293
ASSAM,KARBI ANGLONG,2008,16,12,1,7,0,16,52
ASSAM,KARIMGANJ,2008,19,44,5,10,0,99,177
ASSAM,KOKRAJHAR,2008,55,24,4,16,0,58,157
ASSAM,LAKHIMPUR,2008,52,71,1,24,0,160,308
ASSAM,MORIGAON,2008,75,68,4,57,0,114,318
ASSAM,N.C.HILLS,2008,4,9,0,1,0,3,17
ASSAM,NAGAON,2008,112,209,9,200,0,371,901
ASSAM,NALBARI,2008,30,47,6,42,0,54,179
ASSAM,R.P.O.,2008,5,3,0,1,0,0,9
ASSAM,SIBSAGAR,2008,46,94,4,27,0,139,310
ASSAM,SONITPUR,2008,56,125,6,34,0,294,515
ASSAM,TINSUKIA,2008,60,60,2,8,0,84,214
ASSAM,UDALGURI,2008,42,27,0,7,0,38,114
ASSAM,TOTAL,2008,1438,1789,103,1272,2,3478,8082
BIHAR,ARARIA,2008,37,30,3,35,0,92,197
BIHAR,ARWAL,2008,2,10,13,0,0,8,33
BIHAR,AURANGABAD,2008,30,38,32,13,0,65,178
BIHAR,BAGAHA,2008,15,36,11,14,0,36,112
BIHAR,BANKA,2008,49,38,23,16,0,24,150
BIHAR,BEGUSARAI,2008,25,34,41,3,0,56,159
BIHAR,BETTIAH,2008,28,49,33,0,4,96,210
BIHAR,BHABHUA,2008,8,19,19,10,0,26,82
BIHAR,BHAGALPUR,2008,35,98,27,35,5,120,320
BIHAR,BHOJPUR,2008,18,47,57,31,1,122,276
BIHAR,BUXAR,2008,11,18,29,20,0,19,97
BIHAR,DARBHANGA,2008,67,80,48,53,0,45,293
BIHAR,GAYA,2008,52,77,43,8,0,40,220
BIHAR,GOPALGANJ,2008,23,63,36,27,0,110,259
BIHAR,JAMALPUR RLY.,2008,1,0,1,0,0,0,2
BIHAR,JAMUI,2008,17,21,32,25,0,41,136
BIHAR,JEHANABAD,2008,6,19,23,0,0,17,65
BIHAR,KATIHAR,2008,120,66,15,12,0,28,241
BIHAR,KATIHAR RLY.,2008,2,2,0,5,0,1,10
BIHAR,KHAGARIA,2008,16,17,9,2,0,13,57
BIHAR,KISHANGANJ,2008,30,26,8,0,0,23,87
BIHAR,LAKHISARAI,2008,35,17,11,23,2,12,100
BIHAR,MADHEPURA,2008,16,30,16,10,0,12,84
BIHAR,MADHUBANI,2008,24,36,24,182,0,51,317
BIHAR,MOTIHARI,2008,34,83,45,14,0,12,188
BIHAR,MUNGER,2008,20,31,14,2,0,40,107
BIHAR,MUZAFFARPUR,2008,28,97,75,15,0,90,305
BIHAR,MUZAFFARPUR RLY.,2008,2,0,0,0,0,1,3
BIHAR,NALANDA,2008,23,56,70,36,0,77,262
BIHAR,NAUGACHIA,2008,8,6,5,35,0,65,119
BIHAR,NAWADAH,2008,28,26,24,10,1,36,125
BIHAR,PATNA,2008,57,78,99,31,1,189,455
BIHAR,PATNA RLY.,2008,0,4,2,7,0,1,14
BIHAR,PURNEA,2008,185,88,3,73,0,81,430
BIHAR,ROHTAS,2008,21,55,36,15,0,42,169
BIHAR,SAHARSA,2008,22,20,17,75,0,21,155
BIHAR,SAMASTIPUR,2008,32,62,60,15,5,52,226
BIHAR,SARAN,2008,34,58,58,10,0,41,201
BIHAR,SHEIKHPURA,2008,9,14,7,1,0,10,41
BIHAR,SHEOHAR,2008,7,11,7,4,0,13,42
BIHAR,SITAMARHI,2008,12,43,24,18,0,12,109
BIHAR,SIWAN,2008,24,35,31,9,2,54,155
BIHAR,SUPAUL,2008,53,37,15,71,0,68,244
BIHAR,VAISHALI,2008,36,114,64,34,0,30,278
BIHAR,TOTAL,2008,1302,1789,1210,999,21,1992,7313
CHHATTISGARH,BALRAMPUR,2008,41,5,3,43,0,24,116
CHHATTISGARH,BILASPUR,2008,71,25,19,171,4,136,426
CHHATTISGARH,BIZAPUR,2008,5,2,0,5,0,1,13
CHHATTISGARH,DANTEWARA,2008,10,7,1,17,1,3,39
CHHATTISGARH,DHAMTARI,2008,26,4,3,47,4,19,103
CHHATTISGARH,DURG,2008,109,12,11,218,17,118,485
CHHATTISGARH,GRP RAIPUR,2008,2,0,0,4,2,0,8
CHHATTISGARH,JAGDALPUR,2008,68,11,2,49,2,23,155
CHHATTISGARH,JANJGIR,2008,47,7,14,135,12,123,338
CHHATTISGARH,JASHPUR,2008,71,41,0,56,3,19,190
CHHATTISGARH,KABIRDHAM,2008,29,4,5,79,6,23,146
CHHATTISGARH,KANKER,2008,15,7,4,26,3,13,68
CHHATTISGARH,KORBA,2008,31,9,5,68,10,42,165
CHHATTISGARH,KORIYA,2008,54,5,2,93,6,34,194
CHHATTISGARH,MAHASAMUND,2008,24,7,6,57,4,27,125
CHHATTISGARH,NARAYANPUR,2008,1,0,0,0,0,0,1
CHHATTISGARH,RAIGARH,2008,30,7,7,74,8,45,171
CHHATTISGARH,RAIPUR,2008,128,36,11,247,34,124,580
CHHATTISGARH,RAJNANDGAON,2008,60,12,7,72,5,57,213
CHHATTISGARH,SARGUJA,2008,78,8,3,89,3,27,208
CHHATTISGARH,SURAJPUR,2008,78,7,3,71,1,39,199
CHHATTISGARH,TOTAL,2008,978,216,106,1621,125,897,3943
GOA,NORTH GOA,2008,15,17,0,15,2,5,54
GOA,SOUTH GOA,2008,15,11,2,17,10,7,62
GOA,TOTAL,2008,30,28,2,32,12,12,116
GUJARAT,AHMEDABAD COMMR.,2008,44,137,1,78,19,1185,1464
GUJARAT,AHMEDABAD RURAL,2008,3,35,1,16,0,67,122
GUJARAT,AHWA-DANG,2008,3,2,0,2,0,11,18
GUJARAT,AMRELI,2008,8,58,0,31,3,128,228
GUJARAT,ANAND,2008,11,45,0,25,2,170,253
GUJARAT,BHARUCH,2008,13,29,0,13,2,114,171
GUJARAT,BHAVNAGAR,2008,9,80,0,69,51,197,406
GUJARAT,DAHOD,2008,13,40,0,33,0,63,149
GUJARAT,GANDHINAGAR,2008,8,35,3,18,2,200,266
GUJARAT,HIMATNAGAR,2008,16,34,0,22,0,217,289
GUJARAT,JAMNAGAR,2008,17,25,0,14,1,239,296
GUJARAT,JUNAGADH,2008,5,43,3,66,3,456,576
GUJARAT,KHEDA NORTH,2008,8,39,0,40,0,219,306
GUJARAT,KUTCH,2008,16,42,1,26,6,334,425
GUJARAT,MEHSANA,2008,9,48,0,33,1,289,380
GUJARAT,NARMADA,2008,7,7,0,8,1,12,35
GUJARAT,NAVSARI,2008,2,4,0,1,1,5,13
GUJARAT,PALANPUR,2008,37,43,1,34,0,201,316
GUJARAT,PANCHMAHAL,2008,8,53,0,29,2,148,240
GUJARAT,PATAN,2008,19,24,0,29,0,157,229
GUJARAT,PORBANDAR,2008,3,11,0,5,0,48,67
GUJARAT,RAJKOT COMMR.,2008,12,40,1,30,19,312,414
GUJARAT,RAJKOT RURAL,2008,24,42,4,45,2,293,410
GUJARAT,SURAT COMMR.,2008,28,79,11,54,2,472,646
GUJARAT,SURAT RURAL,2008,3,5,0,7,0,30,45
GUJARAT,SURENDRANAGAR,2008,21,38,0,50,1,133,243
GUJARAT,TAPI,2008,3,2,0,2,0,6,13
GUJARAT,VADODARA COMMR.,2008,7,30,0,16,3,268,324
GUJARAT,VADODARA RURAL,2008,11,37,0,21,0,87,156
GUJARAT,VALSAD,2008,4,9,0,6,0,32,51
GUJARAT,W.RLY,2008,2,3,1,5,1,1,13
GUJARAT,TOTAL,2008,374,1119,27,828,122,6094,8564
HARYANA,AMBALA,2008,35,49,11,27,21,172,315
HARYANA,BHIWANI,2008,33,36,14,24,20,111,238
HARYANA,FARIDABAD,2008,46,94,21,23,97,173,454
HARYANA,FATEHABAD,2008,12,21,4,16,13,143,209
HARYANA,GRP,2008,1,3,6,7,158,0,175
HARYANA,GURGAON,2008,35,66,19,27,32,123,302
HARYANA,HISSAR,2008,23,27,19,25,9,214,317
HARYANA,JHAJJAR,2008,22,15,20,13,42,115,227
HARYANA,JIND,2008,38,23,18,21,15,73,188
HARYANA,KAITHAL,2008,14,16,13,14,0,150,207
HARYANA,KARNAL,2008,50,23,17,31,21,124,266
HARYANA,KURUKSHETRA,2008,41,24,12,11,27,72,187
HARYANA,MAHENDRAGARH,2008,21,20,16,17,0,73,147
HARYANA,MEWAT,2008,29,13,7,6,6,114,175
HARYANA,PALWAL,2008,29,23,15,25,33,89,214
HARYANA,PANCHKULA,2008,15,18,5,6,1,72,117
HARYANA,PANIPAT,2008,30,34,13,16,17,62,172
HARYANA,REWARI,2008,23,25,13,31,0,72,164
HARYANA,ROHTAK,2008,39,20,17,25,38,106,245
HARYANA,SIRSA,2008,31,16,9,14,0,127,197
HARYANA,SONIPAT,2008,36,43,24,31,50,149,333
HARYANA,YAMUNANAGAR,2008,28,35,9,25,5,101,203
HARYANA,TOTAL,2008,631,644,302,435,605,2435,5052
HIMACHAL PRADESH,BILASPUR,2008,10,7,2,28,5,35,87
HIMACHAL PRADESH,CHAMBA,2008,10,16,0,26,0,10,62
HIMACHAL PRADESH,G.R.P.,2008,0,0,0,0,0,0,0
HIMACHAL PRADESH,HAMIRPUR,2008,8,12,0,15,7,39,81
HIMACHAL PRADESH,KANGRA,2008,19,15,0,37,13,68,152
HIMACHAL PRADESH,KINNAUR,2008,4,2,0,3,0,3,12
HIMACHAL PRADESH,KULLU,2008,16,17,0,31,2,28,94
HIMACHAL PRADESH,LAHAUL-SPITI,2008,1,0,0,0,0,1,2
HIMACHAL PRADESH,MANDI,2008,32,13,1,75,8,42,171
HIMACHAL PRADESH,SHIMLA,2008,22,19,0,31,0,33,105
HIMACHAL PRADESH,SIRMAUR,2008,10,13,0,19,0,30,72
HIMACHAL PRADESH,SOLAN,2008,14,13,0,13,2,17,59
HIMACHAL PRADESH,UNA,2008,11,10,0,17,4,37,79
HIMACHAL PRADESH,TOTAL,2008,157,137,3,295,41,343,976
JAMMU & KASHMIR,ANANTNAG,2008,13,74,0,63,17,0,167
JAMMU & KASHMIR,AWANTIPORA,2008,4,13,0,40,1,1,59
JAMMU & KASHMIR,BANDIPORA,2008,1,44,0,74,7,0,126
JAMMU & KASHMIR,BARAMULLA,2008,13,60,0,80,12,1,166
JAMMU & KASHMIR,BUDGAM,2008,8,60,0,88,29,0,185
JAMMU & KASHMIR,CRIME JAMMU,2008,0,0,0,0,0,0,0
JAMMU & KASHMIR,CRIME SRINAGAR,2008,0,0,0,0,0,0,0
JAMMU & KASHMIR,DODA,2008,20,21,0,14,4,8,67
JAMMU & KASHMIR,GANDERBAL,2008,2,21,0,36,1,2,62
JAMMU & KASHMIR,HANDWARA,2008,6,16,0,51,6,1,80
JAMMU & KASHMIR,JAMMU,2008,26,49,7,31,58,54,225
JAMMU & KASHMIR,KARGIL,2008,1,1,0,5,0,0,7
JAMMU & KASHMIR,KATHUA,2008,15,13,7,17,4,7,63
JAMMU & KASHMIR,KISHTWAR,2008,4,12,0,10,1,5,32
JAMMU & KASHMIR,KULGAM,2008,5,43,0,63,4,1,116
JAMMU & KASHMIR,KUPWARA,2008,5,19,0,31,2,2,59
JAMMU & KASHMIR,LEH,2008,6,3,0,7,0,0,16
JAMMU & KASHMIR,POONCH,2008,16,21,0,35,6,13,91
JAMMU & KASHMIR,PULWAMA,2008,2,29,0,13,8,0,52
JAMMU & KASHMIR,RAILWAYS,2008,0,1,0,0,0,0,1
JAMMU & KASHMIR,RAJOURI,2008,21,27,6,34,7,39,134
JAMMU & KASHMIR,RAMBAN,2008,9,14,0,4,4,0,31
JAMMU & KASHMIR,REASI,2008,5,9,0,11,4,2,31
JAMMU & KASHMIR,SAMBA,2008,2,9,1,7,1,3,23
JAMMU & KASHMIR,SHOPIAN,2008,6,14,0,49,5,1,75
JAMMU & KASHMIR,SRINAGAR,2008,16,69,0,162,104,18,369
JAMMU & KASHMIR,UDHAMPUR,2008,13,14,0,10,11,4,52
JAMMU & KASHMIR,TOTAL,2008,219,656,21,935,296,162,2289
JHARKHAND,BOKARO,2008,40,37,15,0,2,65,159
JHARKHAND,CHAIBASA,2008,42,5,7,16,0,33,103
JHARKHAND,CHATRA,2008,11,14,14,1,0,2,42
JHARKHAND,DEOGHAR,2008,33,2,6,5,5,29,80
JHARKHAND,DHANBAD,2008,47,76,36,35,10,57,261
JHARKHAND,DHANBAD RLY.,2008,0,1,2,4,0,2,9
JHARKHAND,DUMKA,2008,60,23,17,7,0,66,173
JHARKHAND,GARHWA,2008,21,16,9,15,0,20,81
JHARKHAND,GIRIDIH,2008,48,44,33,22,1,25,173
JHARKHAND,GODDA,2008,26,6,7,16,0,50,105
JHARKHAND,GUMLA,2008,38,11,0,11,0,8,68
JHARKHAND,HAZARIBAGH,2008,57,61,36,31,0,97,282
JHARKHAND,JAMSHEDPUR,2008,41,16,14,18,5,74,168
JHARKHAND,JAMSHEDPUR RLY.,2008,0,0,0,1,0,1,2
JHARKHAND,JAMTARA,2008,20,3,5,9,0,16,53
JHARKHAND,KHUNTI,2008,8,2,1,1,0,1,13
JHARKHAND,KODERMA,2008,16,14,11,6,0,23,70
JHARKHAND,LATEHAR,2008,11,11,6,10,0,6,44
JHARKHAND,LOHARDAGGA,2008,16,4,2,2,0,7,31
JHARKHAND,PAKUR,2008,53,2,1,9,0,103,168
JHARKHAND,PALAMU,2008,30,31,18,1,0,32,112
JHARKHAND,RAMGARH,2008,11,18,5,6,0,13,53
JHARKHAND,RANCHI,2008,62,62,12,23,0,88,247
JHARKHAND,SAHEBGANJ,2008,61,22,4,14,0,19,120
JHARKHAND,SARAIKELA,2008,13,11,5,8,0,13,50
JHARKHAND,SIMDEGA,2008,26,7,0,0,0,1,34
JHARKHAND,TOTAL,2008,791,499,266,271,23,851,2701
KARNATAKA,BAGALKOT,2008,2,15,6,62,2,56,143
KARNATAKA,BANGALORE COMMR.,2008,54,2,52,179,1,307,595
KARNATAKA,BANGALORE RURAL,2008,14,7,11,56,0,56,144
KARNATAKA,BELGAUM,2008,30,45,9,180,9,233,506
KARNATAKA,BELLARY,2008,11,10,10,41,0,49,121
KARNATAKA,BIDAR,2008,7,17,11,105,2,55,197
KARNATAKA,BIJAPUR,2008,19,17,1,83,0,135,255
KARNATAKA,CBPURA,2008,7,13,9,37,0,22,88
KARNATAKA,CHAMARAJNAGAR,2008,4,3,4,29,0,35,75
KARNATAKA,CHICKMAGALUR,2008,17,10,8,60,6,123,224
KARNATAKA,CHITRADURGA,2008,18,15,6,82,0,49,170
KARNATAKA,DAKSHIN KANNADA,2008,10,6,5,53,4,51,129
KARNATAKA,DAVANAGERE,2008,10,31,9,60,5,102,217
KARNATAKA,DHARWAD COMMR.,2008,3,10,1,16,1,44,75
KARNATAKA,DHARWAD RURAL,2008,1,0,3,16,0,23,43
KARNATAKA,GADAG,2008,10,0,5,49,1,34,99
KARNATAKA,GULBARGA,2008,25,31,7,75,0,169,307
KARNATAKA,HASSAN,2008,17,24,8,76,0,79,204
KARNATAKA,HAVERI,2008,5,0,0,48,0,33,86
KARNATAKA,K.G.F.,2008,5,5,3,14,0,33,60
KARNATAKA,KODAGU,2008,20,5,2,27,1,41,96
KARNATAKA,KOLAR,2008,14,11,14,22,0,21,82
KARNATAKA,KOPPAL,2008,6,12,4,26,0,39,87
KARNATAKA,MANDYA,2008,18,13,11,59,0,72,173
KARNATAKA,MYSORE COMMR.,2008,23,22,4,28,0,151,228
KARNATAKA,MYSORE RURAL,2008,13,7,15,68,0,97,200
KARNATAKA,RAICHUR,2008,19,21,7,86,0,106,239
KARNATAKA,RAILWAYS,2008,0,0,0,1,0,0,1
KARNATAKA,RAMANAGAR,2008,17,8,14,62,0,37,138
KARNATAKA,SHIMOGA,2008,14,23,3,101,5,207,353
KARNATAKA,TUMKUR,2008,12,10,16,90,0,80,208
KARNATAKA,UDUPI,2008,11,3,0,17,0,15,46
KARNATAKA,UTTAR KANNADA,2008,10,9,1,46,7,84,157
KARNATAKA,TOTAL,2008,446,405,259,1954,44,2638,5746
KERALA,ALAPUZHA,2008,16,16,2,224,22,247,527
KERALA,ERNAKULAM COMMR.,2008,12,7,1,59,5,88,172
KERALA,ERNAKULAM RURAL,2008,35,9,3,134,24,175,380
KERALA,IDUKKI,2008,28,12,0,131,3,193,367
KERALA,KANNUR,2008,33,7,1,111,13,276,441
KERALA,KASARGOD,2008,28,6,1,92,6,202,335
KERALA,KOLLAM,2008,61,20,2,273,11,442,809
KERALA,KOTTAYAM,2008,31,11,0,221,32,193,488
KERALA,KOZHIKODE COMMR.,2008,15,4,3,72,10,165,269
KERALA,KOZHIKODE RURAL,2008,39,6,2,151,29,288,515
KERALA,MALAPPURAM,2008,51,7,2,149,28,525,762
KERALA,PALAKKAD,2008,42,8,4,133,4,296,487
KERALA,PATHANAMTHITTA,2008,32,8,0,168,12,173,393
KERALA,RAILWAYS,2008,1,0,0,7,3,0,11
KERALA,THRISSUR,2008,46,12,2,214,29,332,635
KERALA,TRIVANDRUM COMMR.,2008,20,6,1,128,7,115,277
KERALA,TRIVANDRUM RURAL,2008,43,20,7,404,9,314,797
KERALA,WAYANADU,2008,35,7,0,74,11,114,241
KERALA,TOTAL,2008,568,166,31,2745,258,4138,7906
MADHYA PRADESH,ALIRAJPUR,2008,41,14,1,37,1,7,101
MADHYA PRADESH,ANUPPUR,2008,42,2,4,53,1,23,125
MADHYA PRADESH,ASHOK NAGAR,2008,47,3,16,107,8,35,216
MADHYA PRADESH,BALAGHAT,2008,61,6,8,131,11,38,255
MADHYA PRADESH,BARWANI,2008,39,4,1,81,3,6,134
MADHYA PRADESH,BETUL,2008,121,22,17,198,10,50,418
MADHYA PRADESH,BHIND,2008,27,9,30,60,1,38,165
MADHYA PRADESH,BHOPAL,2008,113,36,28,207,39,157,580
MADHYA PRADESH,BHOPAL RLY.,2008,2,2,1,7,3,3,18
MADHYA PRADESH,BURHANPUR,2008,14,2,3,55,0,30,104
MADHYA PRADESH,CHHATARPUR,2008,57,14,22,194,20,58,365
MADHYA PRADESH,CHHINDWARA,2008,120,11,17,185,22,121,476
MADHYA PRADESH,DAMOH,2008,46,12,15,126,0,47,246
MADHYA PRADESH,DATIYA,2008,25,11,17,63,0,32,148
MADHYA PRADESH,DEWAS,2008,73,14,10,191,42,150,480
MADHYA PRADESH,DHAR,2008,100,27,37,185,11,69,429
MADHYA PRADESH,DINDORI,2008,20,1,2,33,1,4,61
MADHYA PRADESH,GUNA,2008,72,13,9,134,16,25,269
MADHYA PRADESH,GWALIOR,2008,42,47,24,126,17,139,395
MADHYA PRADESH,HARDA,2008,18,7,6,42,39,0,112
MADHYA PRADESH,HOSHANGABAD,2008,64,14,16,130,19,44,287
MADHYA PRADESH,INDORE,2008,122,46,35,343,63,369,978
MADHYA PRADESH,INDORE RLY.,2008,3,0,1,5,1,0,10
MADHYA PRADESH,JABALPUR,2008,127,40,42,288,67,146,710
MADHYA PRADESH,JABALPUR RLY.,2008,1,1,0,7,1,0,10
MADHYA PRADESH,JHABUA,2008,31,18,4,32,0,9,94
MADHYA PRADESH,KATNI,2008,48,5,18,97,7,57,232
MADHYA PRADESH,KHANDWA,2008,52,10,5,154,27,37,285
MADHYA PRADESH,KHARGON,2008,65,8,23,154,23,42,315
MADHYA PRADESH,MANDLA,2008,47,2,4,87,14,25,179
MADHYA PRADESH,MANDSAUR,2008,40,15,15,128,4,56,258
MADHYA PRADESH,MORENA,2008,26,21,32,73,1,73,226
MADHYA PRADESH,NARSINGHPUR,2008,61,2,14,100,16,44,237
MADHYA PRADESH,NEEMUCH,2008,19,3,0,45,14,28,109
MADHYA PRADESH,PANNA,2008,28,6,17,77,0,26,154
MADHYA PRADESH,RAISEN,2008,67,17,19,150,0,35,288
MADHYA PRADESH,RAJGARH,2008,83,22,10,166,36,136,453
MADHYA PRADESH,RATLAM,2008,63,14,11,105,11,57,261
MADHYA PRADESH,REWA,2008,82,26,26,124,7,67,332
MADHYA PRADESH,SAGAR,2008,119,28,37,349,38,154,725
MADHYA PRADESH,SATNA,2008,102,15,32,207,9,137,502
MADHYA PRADESH,SEONI,2008,61,14,7,103,14,21,220
MADHYA PRADESH,SHAHDOL,2008,47,13,16,139,9,57,281
MADHYA PRADESH,SHAJAPUR,2008,57,13,12,161,34,77,354
MADHYA PRADESH,SHEOPUR,2008,13,5,0,32,2,19,71
MADHYA PRADESH,SHIVPURI,2008,64,24,16,128,3,53,288
MADHYA PRADESH,SIDHI,2008,37,17,18,83,5,30,190
MADHYA PRADESH,SIHORE,2008,57,18,8,89,16,57,245
MADHYA PRADESH,SINGRAULI,2008,40,12,22,87,1,27,189
MADHYA PRADESH,TIKAMGARH,2008,35,10,25,107,2,36,215
MADHYA PRADESH,UJJAIN,2008,78,25,23,215,37,158,536
MADHYA PRADESH,UMARIYA,2008,25,2,5,60,7,13,112
MADHYA PRADESH,VIDISHA,2008,93,13,24,205,25,63,423
MADHYA PRADESH,TOTAL,2008,2937,736,805,6445,758,3185,14866
MAHARASHTRA,AHMEDNAGAR,2008,49,33,0,125,4,537,748
MAHARASHTRA,AKOLA,2008,26,33,7,111,61,153,391
MAHARASHTRA,AMRAVATI COMMR.,2008,22,9,4,41,10,85,171
MAHARASHTRA,AMRAVATI RURAL,2008,47,18,3,137,33,146,384
MAHARASHTRA,AURANGABAD COMMR.,2008,21,30,4,51,16,138,260
MAHARASHTRA,AURANGABAD RURAL,2008,21,7,39,65,9,226,367
MAHARASHTRA,BEED,2008,26,22,11,92,11,332,494
MAHARASHTRA,BHANDARA,2008,26,13,0,69,18,73,199
MAHARASHTRA,BULDHANA,2008,36,25,9,153,39,250,512
MAHARASHTRA,CHANDRAPUR,2008,37,28,14,112,146,221,558
MAHARASHTRA,DHULE,2008,10,8,3,32,8,196,257
MAHARASHTRA,GADCHIROLI,2008,22,11,2,30,7,46,118
MAHARASHTRA,GONDIA,2008,38,13,3,84,25,58,221
MAHARASHTRA,HINGOLI,2008,17,9,7,54,6,99,192
MAHARASHTRA,JALGAON,2008,42,19,18,107,29,456,671
MAHARASHTRA,JALNA,2008,16,10,27,53,7,309,422
MAHARASHTRA,KOLHAPUR,2008,34,18,17,76,13,153,311
MAHARASHTRA,LATUR,2008,22,29,77,74,0,187,389
MAHARASHTRA,MUMBAI COMMR.,2008,218,116,11,436,121,502,1404
MAHARASHTRA,MUMBAI RLY.,2008,4,2,1,12,0,0,19
MAHARASHTRA,NAGPUR COMMR.,2008,53,28,7,91,71,237,487
MAHARASHTRA,NAGPUR RLY.,2008,1,2,0,8,2,0,13
MAHARASHTRA,NAGPUR RURAL,2008,37,20,7,89,32,95,280
MAHARASHTRA,NANDED,2008,23,22,8,77,6,252,388
MAHARASHTRA,NANDURBAR,2008,11,8,1,21,7,93,141
MAHARASHTRA,NASIK COMMR.,2008,14,21,5,42,10,141,233
MAHARASHTRA,NASIK RURAL,2008,36,17,5,61,24,287,430
MAHARASHTRA,NAVI MUMBAI,2008,12,14,1,31,11,72,141
MAHARASHTRA,OSMANABAD,2008,22,19,2,80,7,183,313
MAHARASHTRA,PARBHANI,2008,12,11,15,56,6,204,304
MAHARASHTRA,PUNE COMMR.,2008,92,80,7,113,73,273,638
MAHARASHTRA,PUNE RLY.,2008,1,1,1,3,0,0,6
MAHARASHTRA,PUNE RURAL,2008,66,30,13,104,30,189,432
MAHARASHTRA,RAIGAD,2008,17,5,5,33,10,41,111
MAHARASHTRA,RATNAGIRI,2008,26,12,0,33,27,55,153
MAHARASHTRA,SANGLI,2008,42,13,12,67,14,140,288
MAHARASHTRA,SATARA,2008,30,14,3,66,26,164,303
MAHARASHTRA,SINDHUDURG,2008,8,2,0,34,15,14,73
MAHARASHTRA,SOLAPUR COMMR.,2008,24,8,0,17,3,66,118
MAHARASHTRA,SOLAPUR RURAL,2008,63,37,9,101,0,241,451
MAHARASHTRA,THANE COMMR.,2008,74,72,12,149,46,384,737
MAHARASHTRA,THANE RURAL,2008,71,36,7,128,24,134,400
MAHARASHTRA,WARDHA,2008,26,22,5,128,36,116,333
MAHARASHTRA,WASHIM,2008,20,18,2,59,18,110,227
MAHARASHTRA,YAVATMAL,2008,43,33,6,114,30,171,397
MAHARASHTRA,TOTAL,2008,1558,998,390,3619,1091,7829,15485
MANIPUR,BISHNUPUR,2008,3,11,0,16,0,4,34
MANIPUR,CHANDEL,2008,0,0,0,0,0,0,0
MANIPUR,CHURACHANDPUR,2008,2,0,0,0,0,0,2
MANIPUR,CID,2008,0,0,0,0,0,0,0
MANIPUR,IMPHAL EAST,2008,9,24,0,14,0,5,52
MANIPUR,IMPHAL WEST,2008,12,31,1,22,0,7,73
MANIPUR,SENAPATI,2008,2,0,0,0,0,0,2
MANIPUR,TAMENGLONG,2008,0,0,0,0,0,0,0
MANIPUR,THOUBAL,2008,9,21,0,5,0,12,47
MANIPUR,UKHRUL,2008,1,0,0,0,0,0,1
MANIPUR,TOTAL,2008,38,87,1,57,0,28,211
MEGHALAYA,GARO HILLS EAST,2008,1,2,0,1,0,0,4
MEGHALAYA,GARO HILLS SOUTH,2008,2,0,0,0,0,0,2
MEGHALAYA,GARO HILLS WEST,2008,10,4,0,21,3,13,51
MEGHALAYA,JAINTIA HILLS,2008,18,4,0,7,0,0,29
MEGHALAYA,KHASI HILLS EAST,2008,34,10,2,14,1,19,80
MEGHALAYA,KHASI HILLS WEST,2008,16,3,0,2,0,0,21
MEGHALAYA,RI-BHOI,2008,7,2,0,9,0,0,18
MEGHALAYA,TOTAL,2008,88,25,2,54,4,32,205
MIZORAM,AIZAWL,2008,39,0,0,36,0,4,79
MIZORAM,CHAMPHAI,2008,7,0,0,5,0,0,12
MIZORAM,KOLASIB,2008,9,1,0,11,0,1,22
MIZORAM,LAWNGTLAI,2008,8,0,0,2,0,0,10
MIZORAM,LUNGLEI,2008,8,0,0,13,0,0,21
MIZORAM,MAMIT,2008,2,0,0,3,0,0,5
MIZORAM,SAIHA,2008,0,0,0,1,0,0,1
MIZORAM,SERCHHIP,2008,4,0,0,7,0,0,11
MIZORAM,TOTAL,2008,77,1,0,78,0,5,161
NAGALAND,DIMAPUR,2008,6,5,0,11,0,2,24
NAGALAND,KIPHIRE,2008,0,0,0,0,0,0,0
NAGALAND,KOHIMA,2008,6,0,0,1,0,2,9
NAGALAND,LONGLENG,2008,0,0,0,0,0,0,0
NAGALAND,MOKOKCHUNG,2008,1,0,0,0,0,0,1
NAGALAND,MON,2008,1,0,0,1,0,0,2
NAGALAND,PEREN,2008,1,0,0,0,0,0,1
NAGALAND,PHEK,2008,2,0,0,1,0,0,3
NAGALAND,TUENSANG,2008,1,0,0,0,0,0,1
NAGALAND,WOKHA,2008,0,2,0,1,1,0,4
NAGALAND,ZUNHEBOTO,2008,1,0,0,0,0,0,1
NAGALAND,TOTAL,2008,19,7,0,15,1,4,46
ODISHA,ANGUL,2008,47,41,16,186,11,61,362
ODISHA,BALASORE,2008,50,44,27,76,24,217,438
ODISHA,BARAGARH,2008,29,7,9,64,6,14,129
ODISHA,BERHAMPUR,2008,23,16,4,90,9,9,151
ODISHA,BHADRAK,2008,58,39,16,73,27,106,319
ODISHA,BOLANGIR,2008,34,19,12,132,8,18,223
ODISHA,BOUDH,2008,5,2,3,61,3,9,83
ODISHA,CUTTACK,2008,35,34,31,16,3,124,243
ODISHA,DCP BBSR,2008,36,24,23,61,7,38,189
ODISHA,DCP CTC,2008,18,17,15,18,3,55,126
ODISHA,DEOGARH,2008,13,6,5,96,3,36,159
ODISHA,DHENKANAL,2008,26,20,19,187,9,31,292
ODISHA,GAJAPATI,2008,8,3,2,52,6,3,74
ODISHA,GANJAM,2008,48,33,13,259,16,12,381
ODISHA,JAGATSINGHPUR,2008,25,27,20,22,0,51,145
ODISHA,JAJPUR,2008,36,62,40,98,15,109,360
ODISHA,JHARSUGUDA,2008,12,8,6,67,8,35,136
ODISHA,KALAHANDI,2008,38,29,3,82,5,27,184
ODISHA,KANDHAMAL,2008,46,11,3,70,2,39,171
ODISHA,KENDRAPARA,2008,30,31,32,8,1,93,195
ODISHA,KEONJHAR,2008,66,46,22,203,27,34,398
ODISHA,KHURDA,2008,25,33,0,14,1,0,73
ODISHA,KORAPUT,2008,47,27,3,113,7,45,242
ODISHA,MALKANGIR,2008,12,7,0,33,5,10,67
ODISHA,MAYURBHANJ,2008,90,45,27,200,23,58,443
ODISHA,NAYAGARH,2008,34,21,10,7,5,85,162
ODISHA,NOWRANGPUR,2008,26,19,0,79,16,32,172
ODISHA,NUAPADA,2008,14,11,2,59,4,37,127
ODISHA,PURI,2008,37,18,13,24,7,87,186
ODISHA,RAYAGADA,2008,19,10,6,54,1,23,113
ODISHA,ROURKELA,2008,38,19,5,98,5,66,231
ODISHA,SAMBALPUR,2008,33,12,6,82,4,39,176
ODISHA,SONEPUR,2008,15,3,1,24,2,8,53
ODISHA,SRP(CUTTACK),2008,1,1,0,6,0,0,8
ODISHA,SRP(ROURKELA),2008,1,2,0,3,1,1,8
ODISHA,SUNDARGARH,2008,38,15,7,65,8,6,139
ODISHA,TOTAL,2008,1113,762,401,2782,282,1618,6958
PUNJAB,AMRITSAR,2008,15,44,6,25,11,66,167
PUNJAB,AMRITSAR RURAL,2008,10,17,6,5,2,27,67
PUNJAB,BARNALA,2008,12,6,1,11,0,10,40
PUNJAB,BATALA,2008,20,13,6,9,0,46,94
PUNJAB,BHATINDA,2008,20,28,4,29,5,39,125
PUNJAB,FARIDKOT,2008,15,10,1,9,0,16,51
PUNJAB,FATEHGARH SAHIB,2008,13,9,0,5,1,31,59
PUNJAB,FEROZPUR,2008,30,22,8,29,0,39,128
PUNJAB,G.R.P,2008,1,0,4,2,0,0,7
PUNJAB,GURDASPUR,2008,24,21,9,15,0,28,97
PUNJAB,HOSHIARPUR,2008,35,17,13,21,0,73,159
PUNJAB,JALANDHAR,2008,51,83,10,52,0,133,329
PUNJAB,KAPURTHALA,2008,24,14,4,19,0,27,88
PUNJAB,KHANNA,2008,12,12,7,5,0,28,64
PUNJAB,LUDHIANA,2008,46,78,10,36,21,92,283
PUNJAB,LUDHIANA RURAL,2008,14,12,4,4,5,19,58
PUNJAB,MANSA,2008,13,9,3,6,0,12,43
PUNJAB,MOGA,2008,19,17,3,19,0,22,80
PUNJAB,MUKTSAR,2008,12,8,3,6,0,19,48
PUNJAB,PATIALA,2008,35,37,13,17,0,116,218
PUNJAB,ROPAR,2008,10,9,2,18,1,27,67
PUNJAB,SAS NGR,2008,20,18,3,0,0,0,41
PUNJAB,SBS NAGAR,2008,14,3,2,9,0,28,56
PUNJAB,TARN TARAN,2008,18,14,2,22,0,24,80
PUNJAB,TOTAL,2008,517,514,128,388,49,984,2580
RAJASTHAN,AJMER,2008,45,84,17,108,0,516,770
RAJASTHAN,ALWAR,2008,88,91,38,134,0,429,780
RAJASTHAN,BANSWARA,2008,42,45,8,66,1,85,247
RAJASTHAN,BARAN,2008,52,45,10,169,0,181,457
RAJASTHAN,BARMER,2008,20,21,14,82,0,116,253
RAJASTHAN,BHARATPUR,2008,74,75,24,39,0,371,583
RAJASTHAN,BHILWARA,2008,42,58,13,77,0,370,560
RAJASTHAN,BIKANER,2008,48,28,12,74,0,306,468
RAJASTHAN,BUNDI,2008,33,52,3,98,0,224,410
RAJASTHAN,CHITTORGARH,2008,40,80,6,73,1,402,602
RAJASTHAN,CHURU,2008,37,22,16,16,0,212,303
RAJASTHAN,DAUSA,2008,21,48,9,34,0,100,212
RAJASTHAN,DHOLPUR,2008,21,46,19,9,0,127,222
RAJASTHAN,DUNGARPUR,2008,26,48,11,66,0,94,245
RAJASTHAN,G.R.P.,2008,2,1,1,17,0,0,21
RAJASTHAN,GANGANAGAR,2008,70,43,16,59,2,276,466
RAJASTHAN,HANUMANGARH,2008,33,29,17,68,0,232,379
RAJASTHAN,JAIPUR EAST,2008,20,61,6,54,2,140,283
RAJASTHAN,JAIPUR NORTH,2008,25,69,5,26,0,149,274
RAJASTHAN,JAIPUR RURAL,2008,35,82,11,108,5,205,446
RAJASTHAN,JAIPUR SOUTH,2008,15,44,9,26,0,162,256
RAJASTHAN,JAISALMER,2008,4,6,10,19,0,24,63
RAJASTHAN,JALORE,2008,13,17,8,50,0,106,194
RAJASTHAN,JHALAWAR,2008,44,44,6,144,2,262,502
RAJASTHAN,JHUNJHUNU,2008,40,35,22,32,0,240,369
RAJASTHAN,JODHPUR CITY,2008,19,35,10,25,1,212,302
RAJASTHAN,JODHPUR RURAL,2008,32,21,17,47,0,81,198
RAJASTHAN,KARAULI,2008,33,32,11,27,0,99,202
RAJASTHAN,KOTA CITY,2008,24,55,10,40,1,307,437
RAJASTHAN,KOTA RURAL,2008,34,26,4,76,0,201,341
RAJASTHAN,NAGAUR,2008,33,48,18,142,0,257,498
RAJASTHAN,PALI,2008,43,79,13,116,1,323,575
RAJASTHAN,PRATAPGARH,2008,49,52,2,51,0,138,292
RAJASTHAN,RAJSAMAND,2008,12,34,0,35,0,195,276
RAJASTHAN,SAWAI MADHOPUR,2008,16,39,6,29,0,144,234
RAJASTHAN,SIKAR,2008,40,38,15,18,0,217,328
RAJASTHAN,SIROHI,2008,17,36,5,66,0,110,234
RAJASTHAN,TONK,2008,22,46,6,41,3,206,324
RAJASTHAN,UDAIPUR,2008,91,148,11,159,0,294,703
RAJASTHAN,TOTAL,2008,1355,1863,439,2520,19,8113,14309
SIKKIM,EAST,2008,5,2,0,5,0,3,15
SIKKIM,NORTH,2008,1,0,0,1,0,0,2
SIKKIM,SOUTH,2008,9,1,0,10,0,0,20
SIKKIM,WEST,2008,5,1,0,3,0,2,11
SIKKIM,TOTAL,2008,20,4,0,19,0,5,48
TAMIL NADU,CHENNAI,2008,35,32,25,46,67,165,370
TAMIL NADU,CHENNAI RLY.,2008,0,1,0,5,0,0,6
TAMIL NADU,CHENNAISUBURBAN,2008,21,24,28,42,42,41,198
TAMIL NADU,COIMBATORE RURAL,2008,14,46,8,107,8,115,298
TAMIL NADU,COIMBATORE URBAN,2008,9,7,6,29,7,62,120
TAMIL NADU,CUDDALORE,2008,16,52,1,29,80,50,228
TAMIL NADU,DHARMAPURI,2008,12,36,2,136,3,43,232
TAMIL NADU,DINDIGUL,2008,13,53,3,47,13,99,228
TAMIL NADU,ERODE,2008,21,45,1,78,16,30,191
TAMIL NADU,KANCHIPURAM,2008,24,18,7,20,2,8,79
TAMIL NADU,KANYAKUMARI,2008,8,42,6,27,70,71,224
TAMIL NADU,KARUR,2008,4,12,4,10,3,13,46
TAMIL NADU,KRISHNAGIRI,2008,20,36,2,40,5,21,124
TAMIL NADU,MADURAI RURAL,2008,18,24,9,72,1,75,199
TAMIL NADU,MADURAI URBAN,2008,4,14,5,11,2,42,78
TAMIL NADU,NAGAPATTINAM,2008,10,24,4,59,1,8,106
TAMIL NADU,NAMAKKAL,2008,19,37,5,49,24,25,159
TAMIL NADU,NILGIRIS,2008,4,4,1,20,0,9,38
TAMIL NADU,PERAMBALUR,2008,26,29,7,70,9,6,147
TAMIL NADU,PUDUKOTTAI,2008,4,31,8,45,2,39,129
TAMIL NADU,RAMNATHAPURAM,2008,6,16,2,34,1,12,71
TAMIL NADU,SALEM RURAL,2008,35,101,3,217,0,94,450
TAMIL NADU,SALEM URBAN,2008,22,27,7,16,11,33,116
TAMIL NADU,SIVAGANGAI,2008,1,35,4,7,16,56,119
TAMIL NADU,THANJAVUR,2008,7,29,7,108,0,20,171
TAMIL NADU,THENI,2008,7,32,4,30,5,35,113
TAMIL NADU,THIRUNELVELI RURAL,2008,42,60,3,115,0,97,317
TAMIL NADU,THIRUNELVELI URBAN,2008,8,12,2,7,49,7,85
TAMIL NADU,THIRUVALLUR,2008,17,22,9,18,0,30,96
TAMIL NADU,THIRUVANNAMALAI,2008,20,34,3,20,47,16,140
TAMIL NADU,THIRUVARUR,2008,6,12,1,51,2,3,75
TAMIL NADU,THOOTHUGUDI,2008,11,40,4,3,343,64,465
TAMIL NADU,TRICHY RLY.,2008,0,0,0,0,0,0,0
TAMIL NADU,TRICHY RURAL,2008,11,26,5,16,0,28,86
TAMIL NADU,TRICHY URBAN,2008,2,4,5,7,37,25,80
TAMIL NADU,VELLORE,2008,21,52,7,25,0,49,154
TAMIL NADU,VILLUPURAM,2008,58,50,6,70,31,88,303
TAMIL NADU,VIRUDHUNAGAR,2008,17,41,3,19,77,69,226
TAMIL NADU,TOTAL,2008,573,1160,207,1705,974,1648,6267
TRIPURA,DHALAI,2008,32,7,2,22,0,34,97
TRIPURA,NORTH,2008,46,21,2,62,0,169,300
TRIPURA,SOUTH,2008,45,27,6,135,0,161,374
TRIPURA,WEST,2008,81,55,6,127,4,371,644
TRIPURA,TOTAL,2008,204,110,16,346,4,735,1415
UTTAR PRADESH,AGRA,2008,42,183,77,123,109,479,1013
UTTAR PRADESH,ALIGARH,2008,62,124,58,37,74,213,568
UTTAR PRADESH,ALLAHABAD,2008,49,124,68,91,55,259,646
UTTAR PRADESH,AMBEDKAR NAGAR,2008,18,45,13,20,20,133,249
UTTAR PRADESH,AURAIYA,2008,11,27,12,7,14,36,107
UTTAR PRADESH,AZAMGARH,2008,24,56,35,17,35,86,253
UTTAR PRADESH,BADAUN,2008,11,41,32,27,47,25,183
UTTAR PRADESH,BAGHPAT,2008,19,43,15,16,8,61,162
UTTAR PRADESH,BAHRAICH,2008,24,62,27,24,22,37,196
UTTAR PRADESH,BALLIA,2008,12,27,20,15,12,43,129
UTTAR PRADESH,BALRAMPUR,2008,12,20,5,12,10,13,72
UTTAR PRADESH,BANDA,2008,35,26,36,70,19,67,253
UTTAR PRADESH,BARABANKI,2008,23,82,47,34,54,110,350
UTTAR PRADESH,BAREILLY,2008,46,121,47,110,89,202,615
UTTAR PRADESH,BASTI,2008,7,18,15,5,15,24,84
UTTAR PRADESH,BIJNOR,2008,30,80,19,52,53,249,483
UTTAR PRADESH,BULANDSHAHAR,2008,28,60,29,51,74,151,393
UTTAR PRADESH,CHANDOLI,2008,4,9,19,10,19,91,152
UTTAR PRADESH,CHITRAKOOT DHAM,2008,22,5,17,21,0,17,82
UTTAR PRADESH,DEORIA,2008,15,13,36,6,17,27,114
UTTAR PRADESH,ETAH,2008,20,66,34,41,17,71,249
UTTAR PRADESH,ETAWAH,2008,19,64,28,43,29,108,291
UTTAR PRADESH,FAIZABAD,2008,23,56,18,26,43,86,252
UTTAR PRADESH,FATEHGARH,2008,23,41,26,35,56,84,265
UTTAR PRADESH,FATEHPUR,2008,16,42,41,32,15,67,213
UTTAR PRADESH,FIROZABAD,2008,27,78,41,43,77,77,343
UTTAR PRADESH,G.R.P.,2008,2,8,0,18,38,0,66
UTTAR PRADESH,GAUTAMBUDH NAGAR,2008,22,49,25,19,53,68,236
UTTAR PRADESH,GHAZIABAD,2008,30,138,39,30,83,202,522
UTTAR PRADESH,GHAZIPUR,2008,6,22,33,17,15,64,157
UTTAR PRADESH,GONDA,2008,27,44,43,39,10,12,175
UTTAR PRADESH,GORAKHPUR,2008,46,117,43,30,43,216,495
UTTAR PRADESH,HAMIRPUR,2008,9,19,13,13,5,10,69
UTTAR PRADESH,HARDOI,2008,42,60,50,67,30,68,317
UTTAR PRADESH,HATHRAS,2008,17,37,27,43,18,92,234
UTTAR PRADESH,J.P.NAGAR,2008,20,34,16,26,37,40,173
UTTAR PRADESH,JALAUN,2008,6,30,37,34,24,47,178
UTTAR PRADESH,JAUNPUR,2008,19,41,44,38,39,161,342
UTTAR PRADESH,JHANSI,2008,7,18,26,24,46,11,132
UTTAR PRADESH,KANNAUJ,2008,11,36,31,27,9,91,205
UTTAR PRADESH,KANPUR DEHAT,2008,26,56,31,64,24,185,386
UTTAR PRADESH,KANPUR NAGAR,2008,72,227,86,136,578,632,1731
UTTAR PRADESH,KANSHIRAM NAGAR,2008,19,29,30,31,5,31,145
UTTAR PRADESH,KAUSHAMBI,2008,26,42,26,59,12,117,282
UTTAR PRADESH,KHIRI,2008,58,91,48,74,29,88,388
UTTAR PRADESH,KUSHI NAGAR,2008,6,14,14,8,6,24,72
UTTAR PRADESH,LALITPUR,2008,16,9,10,11,14,40,100
UTTAR PRADESH,LUCKNOW,2008,82,331,62,226,340,778,1819
UTTAR PRADESH,MAHARAJGANJ,2008,17,26,14,12,14,37,120
UTTAR PRADESH,MAHOBA,2008,12,21,17,24,15,30,119
UTTAR PRADESH,MAINPURI,2008,9,65,38,20,9,40,181
UTTAR PRADESH,MATHURA,2008,24,62,31,64,65,222,468
UTTAR PRADESH,MAU,2008,19,44,12,29,44,74,222
UTTAR PRADESH,MEERUT,2008,50,123,37,73,165,326,774
UTTAR PRADESH,MIRZAPUR,2008,19,19,24,16,6,133,217
UTTAR PRADESH,MORADABAD,2008,75,163,38,117,114,139,646
UTTAR PRADESH,MUZAFFARNAGAR,2008,40,112,28,39,74,258,551
UTTAR PRADESH,PILIBHIT,2008,41,100,35,90,10,359,635
UTTAR PRADESH,PRATAPGARH,2008,33,83,32,52,18,155,373
UTTAR PRADESH,RAIBAREILLY,2008,38,51,33,43,44,90,299
UTTAR PRADESH,RAMPUR,2008,46,83,21,46,17,4,217
UTTAR PRADESH,SAHARANPUR,2008,8,25,23,23,66,153,298
UTTAR PRADESH,SANT KABIRNAGAR,2008,9,40,7,5,18,12,91
UTTAR PRADESH,SHAHJAHANPUR,2008,68,94,68,80,25,10,345
UTTAR PRADESH,SHRAWASTI,2008,6,15,6,13,2,4,46
UTTAR PRADESH,SIDHARTHNAGAR,2008,12,30,16,30,20,30,138
UTTAR PRADESH,SITAPUR,2008,53,129,77,47,21,110,437
UTTAR PRADESH,SONBHADRA,2008,26,24,20,38,37,30,175
UTTAR PRADESH,ST.RAVIDASNAGAR,2008,2,9,11,2,6,16,46
UTTAR PRADESH,SULTANPUR,2008,25,49,12,26,19,43,174
UTTAR PRADESH,UNNAO,2008,36,69,52,50,26,61,294
UTTAR PRADESH,VARANASI,2008,12,38,36,14,98,183,381
UTTAR PRADESH,TOTAL,2008,1871,4439,2237,2955,3374,8312,23188
UTTARAKHAND,ALMORA,2008,2,7,8,5,3,9,34
UTTARAKHAND,BAGESHWAR,2008,2,1,2,3,4,2,14
UTTARAKHAND,CHAMOLI,2008,2,1,1,3,0,3,10
UTTARAKHAND,CHAMPAWAT,2008,2,4,3,0,3,5,17
UTTARAKHAND,DEHRADUN,2008,20,65,9,24,128,85,331
UTTARAKHAND,HARIDWAR,2008,24,47,18,29,122,138,378
UTTARAKHAND,NAINITAL,2008,9,22,10,5,26,21,93
UTTARAKHAND,PAURI GARHWAL,2008,0,3,5,3,6,6,23
UTTARAKHAND,PITHORAGARH,2008,0,0,3,6,0,11,20
UTTARAKHAND,RUDRA PRAYAG,2008,0,0,0,0,2,0,2
UTTARAKHAND,TEHRI GARHWAL,2008,3,3,2,4,8,8,28
UTTARAKHAND,UDHAMSINGH NAGAR,2008,22,64,11,34,0,51,182
UTTARAKHAND,UTTARKASHI,2008,1,5,1,4,4,1,16
UTTARAKHAND,TOTAL,2008,87,222,73,120,306,340,1148
WEST BENGAL,24 PARGANAS NORTH,2008,192,215,67,209,5,1946,2634
WEST BENGAL,24 PARGANAS SOUTH,2008,308,275,53,192,0,2551,3379
WEST BENGAL,ASANSOL,2008,20,12,9,20,0,166,227
WEST BENGAL,BANKURA,2008,46,18,20,45,1,170,300
WEST BENGAL,BIRBHUM,2008,58,27,26,67,0,289,467
WEST BENGAL,BURDWAN,2008,61,28,24,107,2,507,729
WEST BENGAL,COOCHBEHAR,2008,141,92,17,148,0,367,765
WEST BENGAL,DAKSHIN DINAJPUR,2008,47,36,8,78,0,206,375
WEST BENGAL,DARJEELING,2008,47,40,5,60,0,135,287
WEST BENGAL,HOOGHLY,2008,54,50,17,19,0,567,707
WEST BENGAL,HOWRAH,2008,46,89,20,63,0,595,813
WEST BENGAL,HOWRAH G.R.P.,2008,0,2,0,5,0,0,7
WEST BENGAL,JALPAIGURI,2008,334,239,18,376,0,1062,2029
WEST BENGAL,KHARAGPUR G.R.P.,2008,0,0,0,1,0,0,1
WEST BENGAL,KOLKATA,2008,35,92,12,211,81,405,836
WEST BENGAL,MALDA,2008,130,57,12,83,0,401,683
WEST BENGAL,MURSHIDABAD,2008,308,165,34,184,3,1441,2135
WEST BENGAL,NADIA,2008,178,204,46,296,2,1186,1912
WEST BENGAL,PASCHIM MIDNAPUR,2008,56,57,20,58,0,582,773
WEST BENGAL,PURAB MIDNAPUR,2008,60,117,28,45,0,613,863
WEST BENGAL,PURULIA,2008,61,23,4,63,0,193,344
WEST BENGAL,SEALDAH G.R.P.,2008,2,3,0,1,0,0,6
WEST BENGAL,SILIGURI G.R.P.,2008,1,6,0,2,0,1,10
WEST BENGAL,UTTAR DINAJPUR,2008,78,60,11,63,0,280,492
WEST BENGAL,TOTAL,2008,2263,1907,451,2396,94,13663,20774
A & N ISLANDS,ANDAMAN,2008,12,13,2,24,3,25,79
A & N ISLANDS,NICOBAR,2008,0,0,0,0,0,1,1
A & N ISLANDS,TOTAL,2008,12,13,2,24,3,26,80
CHANDIGARH,CHANDIGARH,2008,20,42,3,19,2,49,135
CHANDIGARH,TOTAL,2008,20,42,3,19,2,49,135
D & N HAVELI,D and N HAVELI,2008,6,11,0,4,0,4,25
D & N HAVELI,TOTAL,2008,6,11,0,4,0,4,25
DAMAN & DIU,DAMAN,2008,0,0,0,2,0,0,2
DAMAN & DIU,DIU,2008,0,1,0,0,1,5,7
DAMAN & DIU,TOTAL,2008,0,1,0,2,1,5,9
DELHI,CAW,2008,0,0,0,1,0,104,105
DELHI,CENTRAL,2008,30,61,6,38,12,81,228
DELHI,CRIME BRANCH,2008,0,0,0,0,0,0,0
DELHI,DELHI UT TOTAL,2008,466,1136,129,611,130,1387,3859
DELHI,EAST,2008,73,125,21,93,14,184,510
DELHI,EOW,2008,0,0,0,0,2,0,2
DELHI,GRP(RLY),2008,0,5,1,1,0,1,8
DELHI,IGI AIRPORT,2008,0,0,0,2,0,0,2
DELHI,NEW DELHI,2008,3,14,1,18,3,9,48
DELHI,NORTH,2008,20,61,4,35,9,79,208
DELHI,NORTH-EAST,2008,32,169,17,77,23,172,490
DELHI,NORTH-WEST,2008,59,103,12,48,8,82,312
DELHI,OUTER,2008,59,252,21,48,5,162,547
DELHI,SOUTH,2008,37,51,8,52,16,76,240
DELHI,SOUTH-EAST,2008,61,123,15,82,25,156,462
DELHI,SOUTH-WEST,2008,38,66,9,39,7,109,268
DELHI,STF,2008,0,0,0,0,0,0,0
DELHI,WEST,2008,54,106,14,77,6,172,429
LAKSHADWEEP,LAKSHADWEEP,2008,2,1,0,0,0,1,4
LAKSHADWEEP,TOTAL,2008,2,1,0,0,0,1,4
PUDUCHERRY,KARAIKAL,2008,1,1,0,25,4,2,33
PUDUCHERRY,PUDUCHERRY,2008,7,8,2,40,17,10,84
PUDUCHERRY,TOTAL,2008,8,9,2,65,21,12,117
ANDHRA PRADESH,ADILABAD,2009,67,56,13,192,163,428,919
ANDHRA PRADESH,ANANTAPUR,2009,22,60,14,157,13,143,409
ANDHRA PRADESH,CHITTOOR,2009,33,46,19,120,268,333,819
ANDHRA PRADESH,CUDDAPAH,2009,27,47,17,165,52,124,432
ANDHRA PRADESH,CYBERABAD,2009,82,113,46,173,155,991,1560
ANDHRA PRADESH,EAST GODAVARI,2009,47,60,23,196,178,440,944
ANDHRA PRADESH,GUNTAKAL RLY.,2009,0,0,0,3,1,0,4
ANDHRA PRADESH,GUNTUR,2009,40,62,26,340,451,720,1639
ANDHRA PRADESH,HYDERABAD CITY,2009,47,55,36,295,63,1363,1859
ANDHRA PRADESH,KARIMNAGAR,2009,48,106,40,292,234,635,1355
ANDHRA PRADESH,KHAMMAM,2009,98,96,18,205,152,519,1088
ANDHRA PRADESH,KRISHNA,2009,43,35,14,297,130,402,921
ANDHRA PRADESH,KURNOOL,2009,31,73,17,398,365,239,1123
ANDHRA PRADESH,MAHABOOBNAGAR,2009,74,101,24,215,75,299,788
ANDHRA PRADESH,MEDAK,2009,46,51,27,118,58,368,668
ANDHRA PRADESH,NALGONDA,2009,77,75,41,254,205,364,1016
ANDHRA PRADESH,NELLORE,2009,32,48,3,287,128,305,803
ANDHRA PRADESH,NIZAMABAD,2009,27,41,19,79,75,518,759
ANDHRA PRADESH,PRAKASHAM,2009,27,44,14,197,51,248,581
ANDHRA PRADESH,RANGA REDDY,2009,26,20,20,44,25,108,243
ANDHRA PRADESH,SECUNDERABAD RLY.,2009,0,0,0,3,0,0,3
ANDHRA PRADESH,SRIKAKULAM,2009,21,20,6,67,44,211,369
ANDHRA PRADESH,VIJAYAWADA CITY,2009,23,53,17,177,198,433,901
ANDHRA PRADESH,VIJAYAWADA RLY.,2009,0,0,0,0,0,0,0
ANDHRA PRADESH,VISAKHA RURAL,2009,14,7,8,57,56,167,309
ANDHRA PRADESH,VISAKHAPATNAM,2009,39,26,13,95,54,481,708
ANDHRA PRADESH,VIZIANAGARAM,2009,13,12,8,103,105,297,538
ANDHRA PRADESH,WARANGAL,2009,70,130,49,234,25,432,940
ANDHRA PRADESH,WEST GODAVARI,2009,114,89,14,384,196,729,1526
ANDHRA PRADESH,TOTAL,2009,1188,1526,546,5147,3520,11297,23224
ARUNACHAL PRADESH,ANJAW,2009,0,0,0,0,0,0,0
ARUNACHAL PRADESH,CHANGLANG,2009,8,6,0,3,0,4,21
ARUNACHAL PRADESH,DIBANG VALLEY,2009,3,4,0,2,0,1,10
ARUNACHAL PRADESH,K/KUMEY,2009,5,0,0,0,0,0,5
ARUNACHAL PRADESH,KAMENG EAST,2009,3,3,0,1,0,0,7
ARUNACHAL PRADESH,KAMENG WEST,2009,1,0,0,5,0,1,7
ARUNACHAL PRADESH,LOHIT,2009,8,2,0,5,0,0,15
ARUNACHAL PRADESH,PAPUM PARE,2009,11,3,0,10,6,1,31
ARUNACHAL PRADESH,SIANG EAST,2009,9,3,0,6,0,1,19
ARUNACHAL PRADESH,SIANG UPPER,2009,2,0,0,1,0,0,3
ARUNACHAL PRADESH,SIANG WEST,2009,5,4,0,6,0,4,19
ARUNACHAL PRADESH,SUBANSIRI LOWER,2009,2,1,0,8,0,0,11
ARUNACHAL PRADESH,SUBANSIRI UPPER,2009,1,1,0,5,0,1,8
ARUNACHAL PRADESH,TAWANG,2009,0,0,0,0,0,0,0
ARUNACHAL PRADESH,TIRAP,2009,1,1,0,6,0,0,8
ARUNACHAL PRADESH,UPPER DIBANG VALLEY,2009,0,0,0,0,0,0,0
ARUNACHAL PRADESH,TOTAL,2009,59,28,0,58,6,13,164
ASSAM,BARPETA,2009,123,98,29,130,0,206,586
ASSAM,BASKA,2009,18,23,3,8,0,25,77
ASSAM,BONGAIGAON,2009,54,53,4,5,0,118,234
ASSAM,C.I.D.,2009,0,0,0,0,0,0,0
ASSAM,CACHAR,2009,70,131,23,29,1,479,733
ASSAM,CHIRANG,2009,35,51,1,1,0,51,139
ASSAM,DARRANG,2009,80,96,7,139,0,236,558
ASSAM,DHEMAJI,2009,62,63,1,42,0,110,278
ASSAM,DHUBRI,2009,150,147,20,154,2,375,848
ASSAM,DIBRUGARH,2009,46,6,3,44,0,92,191
ASSAM,G.R.P.,2009,0,0,0,0,0,0,0
ASSAM,GOALPARA,2009,90,89,2,2,0,252,435
ASSAM,GOLAGHAT,2009,35,97,0,46,0,108,286
ASSAM,GUWAHATI CITY,2009,54,231,9,162,0,321,777
ASSAM,HAILAKANDI,2009,45,44,8,12,0,81,190
ASSAM,JORHAT,2009,36,40,1,53,0,116,246
ASSAM,KAMRUP,2009,57,108,3,35,0,108,311
ASSAM,KARBI ANGLONG,2009,17,14,0,9,0,23,63
ASSAM,KARIMGANJ,2009,26,36,12,9,0,106,189
ASSAM,KOKRAJHAR,2009,44,35,1,26,0,70,176
ASSAM,LAKHIMPUR,2009,54,97,3,42,0,187,383
ASSAM,MORIGAON,2009,88,69,3,60,0,98,318
ASSAM,N.C.HILLS,2009,3,6,0,4,0,3,16
ASSAM,NAGAON,2009,162,221,12,134,7,655,1191
ASSAM,NALBARI,2009,31,48,6,76,0,73,234
ASSAM,R.P.O.,2009,7,0,0,0,0,0,7
ASSAM,SIBSAGAR,2009,71,0,4,52,0,149,276
ASSAM,SONITPUR,2009,89,169,11,38,0,246,553
ASSAM,TINSUKIA,2009,58,87,2,8,0,62,217
ASSAM,UDALGURI,2009,26,33,2,22,0,48,131
ASSAM,TOTAL,2009,1631,2092,170,1342,10,4398,9643
BIHAR,ARARIA,2009,28,50,21,4,0,18,121
BIHAR,ARWAL,2009,2,10,10,9,0,6,37
BIHAR,AURANGABAD,2009,19,53,37,16,0,46,171
BIHAR,BAGAHA,2009,8,34,14,44,0,13,113
BIHAR,BANKA,2009,31,45,19,4,1,24,124
BIHAR,BEGUSARAI,2009,12,39,46,10,0,47,154
BIHAR,BETTIAH,2009,22,76,37,3,0,38,176
BIHAR,BHABHUA,2009,4,25,19,0,0,16,64
BIHAR,BHAGALPUR,2009,28,44,15,2,0,47,136
BIHAR,BHOJPUR,2009,11,37,54,0,2,275,379
BIHAR,BUXAR,2009,14,45,26,17,0,50,152
BIHAR,DARBHANGA,2009,27,77,33,10,0,247,394
BIHAR,GAYA,2009,20,66,46,12,0,106,250
BIHAR,GOPALGANJ,2009,37,71,42,39,0,127,316
BIHAR,JAMALPUR RLY.,2009,1,0,0,2,0,0,3
BIHAR,JAMUI,2009,15,21,17,7,0,56,116
BIHAR,JEHANABAD,2009,8,9,43,11,0,42,113
BIHAR,KATIHAR,2009,120,41,17,5,0,55,238
BIHAR,KATIHAR RLY.,2009,1,0,0,2,0,0,3
BIHAR,KHAGARIA,2009,8,28,23,37,0,7,103
BIHAR,KISHANGANJ,2009,33,30,6,0,0,32,101
BIHAR,LAKHISARAI,2009,15,16,13,25,5,25,99
BIHAR,MADHEPURA,2009,11,28,19,4,0,11,73
BIHAR,MADHUBANI,2009,19,78,31,20,0,71,219
BIHAR,MOTIHARI,2009,31,117,49,6,0,41,244
BIHAR,MUNGER,2009,12,48,12,0,0,54,126
BIHAR,MUZAFFARPUR,2009,55,111,77,13,0,109,365
BIHAR,MUZAFFARPUR RLY.,2009,3,1,1,5,0,0,10
BIHAR,NALANDA,2009,33,67,74,88,0,33,295
BIHAR,NAUGACHIA,2009,6,31,9,56,0,13,115
BIHAR,NAWADAH,2009,14,34,21,6,1,60,136
BIHAR,PATNA,2009,46,167,95,21,0,341,670
BIHAR,PATNA RLY.,2009,0,7,3,17,0,0,27
BIHAR,PURNEA,2009,49,25,20,35,3,76,208
BIHAR,ROHTAS,2009,18,11,41,38,0,57,165
BIHAR,SAHARSA,2009,28,9,11,36,0,15,99
BIHAR,SAMASTIPUR,2009,26,27,68,21,0,64,206
BIHAR,SARAN,2009,11,73,57,20,0,132,293
BIHAR,SHEIKHPURA,2009,6,9,8,0,0,14,37
BIHAR,SHEOHAR,2009,4,16,7,6,0,12,45
BIHAR,SITAMARHI,2009,8,81,27,20,0,14,150
BIHAR,SIWAN,2009,14,72,42,6,0,25,159
BIHAR,SUPAUL,2009,26,29,12,21,0,30,118
BIHAR,VAISHALI,2009,45,128,73,28,0,83,357
BIHAR,TOTAL,2009,929,1986,1295,726,12,2532,7480
CHHATTISGARH,BALRAMPUR,2009,43,10,2,40,26,0,121
CHHATTISGARH,BILASPUR,2009,59,32,30,175,17,131,444
CHHATTISGARH,BIZAPUR,2009,10,0,0,1,0,3,14
CHHATTISGARH,DANTEWARA,2009,14,5,0,14,0,5,38
CHHATTISGARH,DHAMTARI,2009,24,7,1,64,3,15,114
CHHATTISGARH,DURG,2009,109,17,8,223,20,124,501
CHHATTISGARH,GRP RAIPUR,2009,0,1,0,1,0,1,3
CHHATTISGARH,JAGDALPUR,2009,60,15,0,36,1,17,129
CHHATTISGARH,JANJGIR,2009,25,11,12,97,10,96,251
CHHATTISGARH,JASHPUR,2009,64,24,3,57,2,25,175
CHHATTISGARH,KABIRDHAM,2009,20,0,1,55,6,29,111
CHHATTISGARH,KANKER,2009,22,4,2,28,2,16,74
CHHATTISGARH,KORBA,2009,35,4,9,82,8,52,190
CHHATTISGARH,KORIYA,2009,70,8,4,83,11,58,234
CHHATTISGARH,MAHASAMUND,2009,28,4,8,60,4,17,121
CHHATTISGARH,NARAYANPUR,2009,1,0,1,4,0,0,6
CHHATTISGARH,RAIGARH,2009,43,18,9,73,4,36,183
CHHATTISGARH,RAIPUR,2009,145,35,26,260,32,120,618
CHHATTISGARH,RAJNANDGAON,2009,47,12,8,78,5,59,209
CHHATTISGARH,SARGUJA,2009,81,15,1,86,0,45,228
CHHATTISGARH,SURAJPUR,2009,76,7,3,81,1,44,212
CHHATTISGARH,TOTAL,2009,976,229,128,1598,152,893,3976
GOA,NORTH GOA,2009,31,10,1,17,5,12,76
GOA,SOUTH GOA,2009,16,12,2,20,5,9,64
GOA,TOTAL,2009,47,22,3,37,10,21,140
GUJARAT,AHMEDABAD COMMR.,2009,63,132,5,74,18,1169,1461
GUJARAT,AHMEDABAD RURAL,2009,9,38,1,17,0,131,196
GUJARAT,AHWA-DANG,2009,3,0,0,2,0,4,9
GUJARAT,AMRELI,2009,8,50,1,21,4,131,215
GUJARAT,ANAND,2009,13,35,0,29,3,231,311
GUJARAT,BHARUCH,2009,18,25,0,22,3,113,181
GUJARAT,BHAVNAGAR,2009,9,64,0,41,42,157,313
GUJARAT,DAHOD,2009,10,40,0,22,0,50,122
GUJARAT,GANDHINAGAR,2009,7,28,0,10,3,174,222
GUJARAT,HIMATNAGAR,2009,15,35,0,23,0,208,281
GUJARAT,JAMNAGAR,2009,17,20,1,18,3,241,300
GUJARAT,JUNAGADH,2009,14,60,1,48,10,473,606
GUJARAT,KHEDA NORTH,2009,15,31,0,27,0,102,175
GUJARAT,KUTCH,2009,10,34,0,27,2,242,315
GUJARAT,MEHSANA,2009,10,50,0,23,1,154,238
GUJARAT,NARMADA,2009,6,3,0,6,0,10,25
GUJARAT,NAVSARI,2009,4,1,0,0,1,31,37
GUJARAT,PALANPUR,2009,26,87,0,55,1,217,386
GUJARAT,PANCHMAHAL,2009,15,51,0,27,3,147,243
GUJARAT,PATAN,2009,19,20,0,43,0,136,218
GUJARAT,PORBANDAR,2009,3,17,0,2,2,53,77
GUJARAT,RAJKOT COMMR.,2009,8,38,1,19,8,271,345
GUJARAT,RAJKOT RURAL,2009,28,52,5,32,3,279,399
GUJARAT,SURAT COMMR.,2009,28,74,9,34,2,351,498
GUJARAT,SURAT RURAL,2009,10,12,0,4,0,21,47
GUJARAT,SURENDRANAGAR,2009,18,54,0,39,3,120,234
GUJARAT,TAPI,2009,7,4,0,0,0,7,18
GUJARAT,VADODARA COMMR.,2009,6,28,0,17,0,178,229
GUJARAT,VADODARA RURAL,2009,23,66,0,35,0,75,199
GUJARAT,VALSAD,2009,10,12,0,5,0,27,54
GUJARAT,W.RLY,2009,1,1,0,5,2,3,12
GUJARAT,TOTAL,2009,433,1162,24,727,114,5506,7966
HARYANA,AMBALA,2009,28,16,14,18,17,155,248
HARYANA,BHIWANI,2009,37,53,17,37,21,88,253
HARYANA,FARIDABAD,2009,35,62,17,26,4,179,323
HARYANA,FATEHABAD,2009,9,34,12,10,7,80,152
HARYANA,GRP,2009,3,1,10,2,216,1,233
HARYANA,GURGAON,2009,29,42,24,21,40,128,284
HARYANA,HISSAR,2009,33,26,15,27,14,208,323
HARYANA,JHAJJAR,2009,20,15,13,20,20,78,166
HARYANA,JIND,2009,35,30,11,33,49,97,255
HARYANA,KAITHAL,2009,24,16,13,20,0,187,260
HARYANA,KARNAL,2009,48,40,17,32,21,225,383
HARYANA,KURUKSHETRA,2009,43,47,5,20,29,101,245
HARYANA,MAHENDRAGARH,2009,10,19,10,13,0,58,110
HARYANA,MEWAT,2009,16,12,5,11,3,181,228
HARYANA,PALWAL,2009,33,25,12,23,0,88,181
HARYANA,PANCHKULA,2009,18,10,1,12,0,72,113
HARYANA,PANIPAT,2009,45,31,19,26,44,117,282
HARYANA,REWARI,2009,19,29,14,19,20,55,156
HARYANA,ROHTAK,2009,36,30,18,30,38,113,265
HARYANA,SIRSA,2009,24,28,6,10,0,97,165
HARYANA,SONIPAT,2009,32,42,17,21,46,129,287
HARYANA,YAMUNANAGAR,2009,26,51,11,20,16,180,304
HARYANA,TOTAL,2009,603,659,281,451,605,2617,5216
HIMACHAL PRADESH,BADDIPOLICEDIST,2009,2,1,0,5,0,9,17
HIMACHAL PRADESH,BILASPUR,2009,14,5,1,28,4,21,73
HIMACHAL PRADESH,CHAMBA,2009,20,15,0,29,0,14,78
HIMACHAL PRADESH,CID,2009,0,0,0,0,0,0,0
HIMACHAL PRADESH,G.R.P.,2009,0,0,0,0,0,0,0
HIMACHAL PRADESH,HAMIRPUR,2009,9,14,0,22,5,30,80
HIMACHAL PRADESH,KANGRA,2009,23,22,0,49,5,49,148
HIMACHAL PRADESH,KINNAUR,2009,6,1,0,3,0,2,12
HIMACHAL PRADESH,KULLU,2009,24,10,0,23,1,16,74
HIMACHAL PRADESH,LAHAUL-SPITI,2009,1,0,0,0,2,2,5
HIMACHAL PRADESH,MANDI,2009,22,11,0,59,5,29,126
HIMACHAL PRADESH,SHIMLA,2009,28,22,0,32,5,39,126
HIMACHAL PRADESH,SIRMAUR,2009,15,9,0,34,2,28,88
HIMACHAL PRADESH,SOLAN,2009,8,6,0,13,2,15,44
HIMACHAL PRADESH,UNA,2009,11,6,0,21,6,30,74
HIMACHAL PRADESH,TOTAL,2009,183,122,1,318,37,284,945
JAMMU & KASHMIR,ANANTNAG,2009,8,81,0,84,38,4,215
JAMMU & KASHMIR,AWANTIPORA,2009,5,11,0,17,0,0,33
JAMMU & KASHMIR,BANDIPORA,2009,4,49,0,66,11,0,130
JAMMU & KASHMIR,BARAMULLA,2009,14,80,0,127,25,0,246
JAMMU & KASHMIR,BUDGAM,2009,10,71,0,105,34,1,221
JAMMU & KASHMIR,CRIME JAMMU,2009,0,0,0,0,0,0,0
JAMMU & KASHMIR,CRIME SRINAGAR,2009,0,0,0,0,0,0,0
JAMMU & KASHMIR,DODA,2009,18,38,0,21,10,19,106
JAMMU & KASHMIR,GANDERBAL,2009,7,25,0,45,2,3,82
JAMMU & KASHMIR,HANDWARA,2009,5,16,0,46,5,0,72
JAMMU & KASHMIR,JAMMU,2009,29,66,10,29,59,62,255
JAMMU & KASHMIR,KARGIL,2009,1,1,0,1,0,0,3
JAMMU & KASHMIR,KATHUA,2009,9,23,1,16,8,4,61
JAMMU & KASHMIR,KISHTWAR,2009,3,23,0,3,5,5,39
JAMMU & KASHMIR,KULGAM,2009,9,50,0,73,9,0,141
JAMMU & KASHMIR,KUPWARA,2009,6,22,0,20,7,3,58
JAMMU & KASHMIR,LEH,2009,2,1,0,3,0,0,6
JAMMU & KASHMIR,POONCH,2009,12,19,0,29,1,17,78
JAMMU & KASHMIR,PULWAMA,2009,5,25,0,18,7,0,55
JAMMU & KASHMIR,RAILWAYS,2009,0,0,0,0,2,0,2
JAMMU & KASHMIR,RAILWAYS KMR,2009,0,0,0,2,0,0,2
JAMMU & KASHMIR,RAJOURI,2009,22,33,1,25,3,44,128
JAMMU & KASHMIR,RAMBAN,2009,12,15,0,8,6,0,41
JAMMU & KASHMIR,REASI,2009,9,13,0,10,7,0,39
JAMMU & KASHMIR,SAMBA,2009,6,7,0,4,4,5,26
JAMMU & KASHMIR,SHOPIAN,2009,5,41,0,48,5,0,99
JAMMU & KASHMIR,SRINAGAR,2009,21,106,0,165,118,27,437
JAMMU & KASHMIR,UDHAMPUR,2009,15,9,0,7,5,2,38
JAMMU & KASHMIR,TOTAL,2009,237,825,12,972,371,196,2613
JHARKHAND,BOKARO,2009,18,33,16,2,0,77,146
JHARKHAND,CHAIBASA,2009,34,13,6,23,0,37,113
JHARKHAND,CHATRA,2009,16,20,11,0,0,7,54
JHARKHAND,DEOGHAR,2009,45,15,18,4,22,36,140
JHARKHAND,DHANBAD,2009,36,65,45,24,3,59,232
JHARKHAND,DHANBAD RLY.,2009,0,0,0,3,0,1,4
JHARKHAND,DUMKA,2009,61,21,5,2,0,56,145
JHARKHAND,GARHWA,2009,27,31,12,11,0,35,116
JHARKHAND,GIRIDIH,2009,28,0,45,37,51,3,164
JHARKHAND,GODDA,2009,24,29,7,20,0,30,110
JHARKHAND,GUMLA,2009,39,14,1,7,0,12,73
JHARKHAND,HAZARIBAGH,2009,33,48,32,9,0,9,131
JHARKHAND,JAMSHEDPUR,2009,46,40,8,33,4,78,209
JHARKHAND,JAMSHEDPUR RLY.,2009,1,3,0,1,0,2,7
JHARKHAND,JAMTARA,2009,21,0,10,14,0,14,59
JHARKHAND,KHUNTI,2009,4,5,0,2,0,6,17
JHARKHAND,KODERMA,2009,6,11,13,8,2,37,77
JHARKHAND,LATEHAR,2009,13,15,6,4,0,2,40
JHARKHAND,LOHARDAGGA,2009,20,5,1,5,0,14,45
JHARKHAND,PAKUR,2009,46,6,3,12,0,33,100
JHARKHAND,PALAMU,2009,37,40,18,18,0,34,147
JHARKHAND,RAMGARH,2009,16,18,12,5,0,20,71
JHARKHAND,RANCHI,2009,63,42,19,12,0,68,204
JHARKHAND,SAHEBGANJ,2009,45,27,4,16,1,33,126
JHARKHAND,SARAIKELA,2009,23,11,3,1,0,7,45
JHARKHAND,SIMDEGA,2009,17,5,0,3,0,0,25
JHARKHAND,TOTAL,2009,719,517,295,276,83,710,2600
KARNATAKA,BAGALKOT,2009,8,9,7,59,0,58,141
KARNATAKA,BANGALORE COMMR.,2009,65,2,50,251,35,367,770
KARNATAKA,BANGALORE RURAL,2009,14,4,14,48,0,79,159
KARNATAKA,BELGAUM,2009,39,43,10,220,3,311,626
KARNATAKA,BELLARY,2009,11,19,7,66,0,75,178
KARNATAKA,BIDAR,2009,12,4,3,38,0,81,138
KARNATAKA,BIJAPUR,2009,19,23,0,73,0,139,254
KARNATAKA,CBPURA,2009,11,18,11,43,1,38,122
KARNATAKA,CHAMARAJNAGAR,2009,8,7,6,55,0,44,120
KARNATAKA,CHICKMAGALUR,2009,13,12,1,64,5,104,199
KARNATAKA,CHITRADURGA,2009,26,21,10,102,0,83,242
KARNATAKA,DAKSHIN KANNADA,2009,14,5,1,61,2,69,152
KARNATAKA,DAVANAGERE,2009,16,15,12,90,0,112,245
KARNATAKA,DHARWAD COMMR.,2009,6,9,5,12,1,52,85
KARNATAKA,DHARWAD RURAL,2009,4,1,3,29,0,31,68
KARNATAKA,GADAG,2009,4,7,0,44,0,34,89
KARNATAKA,GULBARGA,2009,32,41,8,68,0,170,319
KARNATAKA,HASSAN,2009,22,15,15,75,0,103,230
KARNATAKA,HAVERI,2009,5,0,3,50,0,47,105
KARNATAKA,K.G.F.,2009,9,0,4,10,0,18,41
KARNATAKA,KODAGU,2009,14,8,5,24,2,46,99
KARNATAKA,KOLAR,2009,10,8,11,17,2,18,66
KARNATAKA,KOPPAL,2009,14,13,5,32,0,57,121
KARNATAKA,MANDYA,2009,16,19,8,85,0,125,253
KARNATAKA,MYSORE COMMR.,2009,14,19,6,22,0,188,249
KARNATAKA,MYSORE RURAL,2009,21,9,18,89,0,114,251
KARNATAKA,RAICHUR,2009,21,18,9,85,4,141,278
KARNATAKA,RAILWAYS,2009,1,0,1,2,0,0,4
KARNATAKA,RAMANAGAR,2009,12,13,11,70,0,62,168
KARNATAKA,SHIMOGA,2009,15,27,5,137,3,255,442
KARNATAKA,TUMKUR,2009,19,6,13,85,0,79,202
KARNATAKA,UDUPI,2009,5,3,0,26,1,22,57
KARNATAKA,UTTAR KANNADA,2009,9,10,2,54,5,63,143
KARNATAKA,TOTAL,2009,509,408,264,2186,64,3185,6616
KERALA,ALAPUZHA,2009,26,10,1,174,23,217,451
KERALA,ERNAKULAM COMMR.,2009,20,5,1,49,14,95,184
KERALA,ERNAKULAM RURAL,2009,26,10,0,130,24,161,351
KERALA,IDUKKI,2009,23,1,1,130,20,199,374
KERALA,KANNUR,2009,37,5,0,131,16,280,469
KERALA,KASARGOD,2009,47,3,0,77,6,190,323
KERALA,KOLLAM,2009,51,19,2,299,11,432,814
KERALA,KOTTAYAM,2009,28,8,0,162,34,192,424
KERALA,KOZHIKODE COMMR.,2009,18,3,2,66,40,167,296
KERALA,KOZHIKODE RURAL,2009,33,22,1,137,14,267,474
KERALA,MALAPPURAM,2009,35,10,0,141,33,545,764
KERALA,PALAKKAD,2009,49,7,3,105,30,315,509
KERALA,PATHANAMTHITTA,2009,24,10,0,156,19,120,329
KERALA,RAILWAYS,2009,0,0,0,11,6,0,17
KERALA,THRISSUR,2009,32,10,3,153,29,345,572
KERALA,TRIVANDRUM COMMR.,2009,40,13,1,175,43,106,378
KERALA,TRIVANDRUM RURAL,2009,57,32,3,382,18,279,771
KERALA,WAYANADU,2009,22,5,2,62,15,97,203
KERALA,TOTAL,2009,568,173,20,2540,395,4007,7703
MADHYA PRADESH,ALIRAJPUR,2009,31,10,1,22,0,1,65
MADHYA PRADESH,ANUPPUR,2009,35,6,8,65,2,50,166
MADHYA PRADESH,ASHOK NAGAR,2009,38,5,6,79,3,45,176
MADHYA PRADESH,BALAGHAT,2009,62,8,7,96,4,37,214
MADHYA PRADESH,BARWANI,2009,31,5,3,53,7,11,110
MADHYA PRADESH,BETUL,2009,130,30,18,155,15,71,419
MADHYA PRADESH,BHIND,2009,23,24,38,57,13,67,222
MADHYA PRADESH,BHOPAL,2009,152,58,46,244,34,231,765
MADHYA PRADESH,BHOPAL RLY.,2009,3,1,2,12,2,0,20
MADHYA PRADESH,BURHANPUR,2009,14,3,12,47,5,21,102
MADHYA PRADESH,CHHATARPUR,2009,64,15,17,178,6,85,365
MADHYA PRADESH,CHHINDWARA,2009,138,27,18,252,36,160,631
MADHYA PRADESH,DAMOH,2009,39,17,23,147,0,70,296
MADHYA PRADESH,DATIYA,2009,20,17,13,69,0,32,151
MADHYA PRADESH,DEWAS,2009,59,9,7,154,20,142,391
MADHYA PRADESH,DHAR,2009,99,32,41,167,18,87,444
MADHYA PRADESH,DINDORI,2009,35,1,4,48,5,38,131
MADHYA PRADESH,GUNA,2009,54,8,11,124,14,38,249
MADHYA PRADESH,GWALIOR,2009,73,67,23,183,20,209,575
MADHYA PRADESH,HARDA,2009,19,4,3,36,7,5,74
MADHYA PRADESH,HOSHANGABAD,2009,59,23,10,114,21,101,328
MADHYA PRADESH,INDORE,2009,82,29,44,419,91,484,1149
MADHYA PRADESH,INDORE RLY.,2009,0,1,0,1,1,0,3
MADHYA PRADESH,JABALPUR,2009,129,33,26,221,63,186,658
MADHYA PRADESH,JABALPUR RLY.,2009,1,1,0,6,2,1,11
MADHYA PRADESH,JHABUA,2009,30,18,5,42,0,9,104
MADHYA PRADESH,KATNI,2009,48,10,21,117,17,87,300
MADHYA PRADESH,KHANDWA,2009,70,12,6,149,19,37,293
MADHYA PRADESH,KHARGON,2009,45,5,27,142,9,29,257
MADHYA PRADESH,MANDLA,2009,43,9,4,58,12,19,145
MADHYA PRADESH,MANDSAUR,2009,46,17,4,124,17,93,301
MADHYA PRADESH,MORENA,2009,31,29,37,83,5,66,251
MADHYA PRADESH,NARSINGHPUR,2009,52,4,26,101,23,42,248
MADHYA PRADESH,NEEMUCH,2009,34,10,1,52,6,34,137
MADHYA PRADESH,PANNA,2009,31,4,22,76,0,32,165
MADHYA PRADESH,RAISEN,2009,93,8,19,165,16,66,367
MADHYA PRADESH,RAJGARH,2009,68,27,9,153,25,76,358
MADHYA PRADESH,RATLAM,2009,67,18,6,111,21,73,296
MADHYA PRADESH,REWA,2009,73,25,44,119,2,80,343
MADHYA PRADESH,SAGAR,2009,127,40,46,361,5,168,747
MADHYA PRADESH,SATNA,2009,145,18,40,194,11,119,527
MADHYA PRADESH,SEONI,2009,61,8,15,85,14,26,209
MADHYA PRADESH,SHAHDOL,2009,42,8,11,113,5,73,252
MADHYA PRADESH,SHAJAPUR,2009,79,13,8,138,22,71,331
MADHYA PRADESH,SHEOPUR,2009,14,3,5,18,0,26,66
MADHYA PRADESH,SHIVPURI,2009,55,20,16,124,8,43,266
MADHYA PRADESH,SIDHI,2009,24,13,20,80,6,36,179
MADHYA PRADESH,SIHORE,2009,63,23,9,88,16,47,246
MADHYA PRADESH,SINGRAULI,2009,45,14,16,92,2,72,241
MADHYA PRADESH,TIKAMGARH,2009,67,12,18,136,3,52,288
MADHYA PRADESH,UJJAIN,2009,46,23,20,167,45,210,511
MADHYA PRADESH,UMARIYA,2009,29,3,3,54,0,38,127
MADHYA PRADESH,VIDISHA,2009,80,13,19,216,30,87,445
MADHYA PRADESH,TOTAL,2009,2998,841,858,6307,728,3983,15715
MAHARASHTRA,AHMEDNAGAR,2009,55,25,0,106,0,557,743
MAHARASHTRA,AKOLA,2009,21,26,10,97,63,131,348
MAHARASHTRA,AMRAVATI COMMR.,2009,17,20,0,28,27,99,191
MAHARASHTRA,AMRAVATI RURAL,2009,49,27,1,121,34,149,381
MAHARASHTRA,AURANGABAD COMMR.,2009,22,17,5,61,21,159,285
MAHARASHTRA,AURANGABAD RURAL,2009,14,4,28,49,4,248,347
MAHARASHTRA,BEED,2009,26,20,16,79,10,389,540
MAHARASHTRA,BHANDARA,2009,17,12,4,31,13,68,145
MAHARASHTRA,BULDHANA,2009,27,23,27,128,55,221,481
MAHARASHTRA,CHANDRAPUR,2009,44,17,9,132,171,158,531
MAHARASHTRA,DHULE,2009,12,9,7,34,8,281,351
MAHARASHTRA,GADCHIROLI,2009,12,13,1,23,6,27,82
MAHARASHTRA,GONDIA,2009,33,17,3,67,21,48,189
MAHARASHTRA,HINGOLI,2009,10,12,3,27,8,106,166
MAHARASHTRA,JALGAON,2009,30,25,10,109,39,423,636
MAHARASHTRA,JALNA,2009,22,17,25,54,14,346,478
MAHARASHTRA,KOLHAPUR,2009,35,18,18,61,15,130,277
MAHARASHTRA,LATUR,2009,33,28,15,49,0,159,284
MAHARASHTRA,MUMBAI COMMR.,2009,182,86,15,400,101,434,1218
MAHARASHTRA,MUMBAI RLY.,2009,4,0,0,12,4,0,20
MAHARASHTRA,NAGPUR COMMR.,2009,45,52,7,60,39,232,435
MAHARASHTRA,NAGPUR RLY.,2009,1,1,0,7,2,0,11
MAHARASHTRA,NAGPUR RURAL,2009,33,13,6,71,22,84,229
MAHARASHTRA,NANDED,2009,34,29,30,62,3,346,504
MAHARASHTRA,NANDURBAR,2009,23,13,1,33,11,75,156
MAHARASHTRA,NASIK COMMR.,2009,24,16,5,49,20,131,245
MAHARASHTRA,NASIK RURAL,2009,46,20,9,64,31,290,460
MAHARASHTRA,NAVI MUMBAI,2009,19,10,6,36,34,84,189
MAHARASHTRA,OSMANABAD,2009,20,16,3,64,9,153,265
MAHARASHTRA,PARBHANI,2009,30,14,7,49,7,219,326
MAHARASHTRA,PUNE COMMR.,2009,67,84,7,100,72,235,565
MAHARASHTRA,PUNE RLY.,2009,1,1,0,0,0,0,2
MAHARASHTRA,PUNE RURAL,2009,72,38,9,133,15,218,485
MAHARASHTRA,RAIGAD,2009,21,3,4,26,19,30,103
MAHARASHTRA,RATNAGIRI,2009,14,8,0,36,20,51,129
MAHARASHTRA,SANGLI,2009,37,9,12,45,10,66,179
MAHARASHTRA,SATARA,2009,26,18,4,57,7,131,243
MAHARASHTRA,SINDHUDURG,2009,8,3,1,12,6,11,41
MAHARASHTRA,SOLAPUR COMMR.,2009,22,6,0,10,5,68,111
MAHARASHTRA,SOLAPUR RURAL,2009,50,29,5,96,0,210,390
MAHARASHTRA,THANE COMMR.,2009,66,55,12,148,52,387,720
MAHARASHTRA,THANE RURAL,2009,53,20,1,97,30,106,307
MAHARASHTRA,WARDHA,2009,41,15,1,84,32,100,273
MAHARASHTRA,WASHIM,2009,25,12,5,61,16,109,228
MAHARASHTRA,YAVATMAL,2009,40,25,9,128,23,212,437
MAHARASHTRA,TOTAL,2009,1483,926,341,3196,1099,7681,14726
MANIPUR,BISHNUPUR,2009,2,5,0,10,0,0,17
MANIPUR,CHANDEL,2009,0,0,0,0,0,0,0
MANIPUR,CHURACHANDPUR,2009,3,3,0,1,0,0,7
MANIPUR,CID,2009,0,0,0,0,0,0,0
MANIPUR,IMPHAL EAST,2009,7,36,0,12,0,4,59
MANIPUR,IMPHAL WEST,2009,8,30,0,9,1,9,57
MANIPUR,SENAPATI,2009,1,0,0,1,0,0,2
MANIPUR,TAMENGLONG,2009,0,0,0,0,0,0,0
MANIPUR,THOUBAL,2009,9,23,0,6,1,12,51
MANIPUR,UKHRUL,2009,1,0,0,0,0,0,1
MANIPUR,TOTAL,2009,31,97,0,39,2,25,194
MEGHALAYA,GARO HILLS EAST,2009,3,1,0,6,1,0,11
MEGHALAYA,GARO HILLS SOUTH,2009,0,0,0,2,0,1,3
MEGHALAYA,GARO HILLS WEST,2009,8,13,0,22,0,13,56
MEGHALAYA,JAINTIA HILLS,2009,24,1,0,8,0,0,33
MEGHALAYA,KHASI HILLS EAST,2009,34,7,0,26,0,9,76
MEGHALAYA,KHASI HILLS WEST,2009,20,0,0,4,0,0,24
MEGHALAYA,RI-BHOI,2009,23,4,0,4,0,1,32
MEGHALAYA,TOTAL,2009,112,26,0,72,1,24,235
MIZORAM,AIZAWL,2009,27,0,0,29,0,4,60
MIZORAM,CHAMPHAI,2009,15,0,0,4,0,0,19
MIZORAM,KOLASIB,2009,7,0,0,9,0,0,16
MIZORAM,LAWNGTLAI,2009,5,0,0,0,0,0,5
MIZORAM,LUNGLEI,2009,12,0,0,8,1,0,21
MIZORAM,MAMIT,2009,9,0,0,4,0,0,13
MIZORAM,SAIHA,2009,3,0,0,0,0,0,3
MIZORAM,SERCHHIP,2009,5,0,0,7,0,0,12
MIZORAM,TOTAL,2009,83,0,0,61,1,4,149
NAGALAND,DIMAPUR,2009,7,4,0,7,0,0,18
NAGALAND,KIPHIRE,2009,0,0,0,0,0,0,0
NAGALAND,KOHIMA,2009,6,4,0,0,0,0,10
NAGALAND,LONGLENG,2009,0,0,0,0,0,0,0
NAGALAND,MOKOKCHUNG,2009,0,0,0,0,0,0,0
NAGALAND,MON,2009,0,0,0,0,0,0,0
NAGALAND,PEREN,2009,2,0,0,1,0,0,3
NAGALAND,PHEK,2009,0,0,0,1,0,0,1
NAGALAND,TUENSANG,2009,1,0,0,1,0,0,2
NAGALAND,WOKHA,2009,3,0,0,1,0,0,4
NAGALAND,ZUNHEBOTO,2009,3,2,0,0,0,0,5
NAGALAND,TOTAL,2009,22,10,0,11,0,0,43
ODISHA,ANGUL,2009,59,30,10,224,8,82,413
ODISHA,BALASORE,2009,46,55,46,124,22,244,537
ODISHA,BARAGARH,2009,25,10,7,86,10,36,174
ODISHA,BERHAMPUR,2009,18,15,3,130,2,12,180
ODISHA,BHADRAK,2009,46,39,23,108,9,134,359
ODISHA,BOLANGIR,2009,46,25,5,147,10,97,330
ODISHA,BOUDH,2009,7,1,4,27,0,6,45
ODISHA,CUTTACK,2009,25,46,30,24,5,133,263
ODISHA,DCP BBSR,2009,32,22,17,50,9,46,176
ODISHA,DCP CTC,2009,14,20,8,31,2,78,153
ODISHA,DEOGARH,2009,12,8,2,55,2,12,91
ODISHA,DHENKANAL,2009,23,19,15,159,4,30,250
ODISHA,GAJAPATI,2009,9,7,1,49,9,14,89
ODISHA,GANJAM,2009,34,28,27,249,21,21,380
ODISHA,JAGATSINGHPUR,2009,31,18,19,11,0,70,149
ODISHA,JAJPUR,2009,32,51,30,86,6,110,315
ODISHA,JHARSUGUDA,2009,7,6,5,41,4,25,88
ODISHA,KALAHANDI,2009,30,24,7,75,8,53,197
ODISHA,KANDHAMAL,2009,24,15,6,66,2,34,147
ODISHA,KENDRAPARA,2009,28,35,11,5,1,17,97
ODISHA,KEONJHAR,2009,53,33,20,195,16,45,362
ODISHA,KHURDA,2009,27,35,11,13,3,133,222
ODISHA,KORAPUT,2009,41,27,2,82,3,95,250
ODISHA,MALKANGIR,2009,15,10,0,21,2,17,65
ODISHA,MAYURBHANJ,2009,80,60,26,214,13,152,545
ODISHA,NAYAGARH,2009,29,22,11,12,3,87,164
ODISHA,NOWRANGPUR,2009,35,21,1,60,13,30,160
ODISHA,NUAPADA,2009,17,10,1,53,3,14,98
ODISHA,PURI,2009,29,38,20,22,2,71,182
ODISHA,RAYAGADA,2009,36,16,3,55,2,35,147
ODISHA,ROURKELA,2009,38,20,5,83,4,58,208
ODISHA,SAMBALPUR,2009,35,12,0,38,6,28,119
ODISHA,SONEPUR,2009,17,3,3,46,1,15,85
ODISHA,SRP(CUTTACK),2009,2,3,1,7,0,0,13
ODISHA,SRP(ROURKELA),2009,1,2,0,8,0,2,13
ODISHA,SUNDARGARH,2009,20,13,4,41,5,11,94
ODISHA,TOTAL,2009,1023,799,384,2697,210,2047,7160
PUNJAB,AMRITSAR,2009,15,37,7,15,6,85,165
PUNJAB,AMRITSAR RURAL,2009,14,14,4,6,0,26,64
PUNJAB,BARNALA,2009,13,5,1,6,0,7,32
PUNJAB,BATALA,2009,21,10,4,11,0,40,86
PUNJAB,BHATINDA,2009,32,29,5,16,1,43,126
PUNJAB,FARIDKOT,2009,17,6,3,9,0,21,56
PUNJAB,FATEHGARH SAHIB,2009,7,4,3,8,3,21,46
PUNJAB,FEROZPUR,2009,43,31,6,13,0,32,125
PUNJAB,G.R.P,2009,1,0,2,0,0,0,3
PUNJAB,GURDASPUR,2009,14,26,2,12,0,40,94
PUNJAB,HOSHIARPUR,2009,37,24,9,12,1,57,140
PUNJAB,JALANDHAR,2009,35,71,13,61,0,140,320
PUNJAB,KAPURTHALA,2009,21,14,3,5,0,23,66
PUNJAB,KHANNA,2009,10,5,3,7,0,35,60
PUNJAB,LUDHIANA,2009,39,70,10,31,9,92,251
PUNJAB,LUDHIANA RURAL,2009,13,20,4,3,0,37,77
PUNJAB,MANSA,2009,13,9,8,13,1,11,55
PUNJAB,MOGA,2009,18,12,2,19,1,24,76
PUNJAB,MUKTSAR,2009,20,8,2,2,0,14,46
PUNJAB,PATIALA,2009,28,46,12,20,0,152,258
PUNJAB,ROPAR,2009,13,14,3,9,3,20,62
PUNJAB,SANGRUR,2009,25,12,9,6,2,60,114
PUNJAB,SAS NGR,2009,23,27,6,15,5,32,108
PUNJAB,SBS NAGAR,2009,12,6,2,4,0,43,67
PUNJAB,TARN TARAN,2009,27,13,3,16,1,6,66
PUNJAB,TOTAL,2009,511,513,126,319,33,1061,2563
RAJASTHAN,AJMER,2009,47,69,17,64,1,546,744
RAJASTHAN,ALWAR,2009,101,128,35,139,0,516,919
RAJASTHAN,BANSWARA,2009,40,49,3,43,0,143,278
RAJASTHAN,BARAN,2009,55,84,9,130,1,289,568
RAJASTHAN,BARMER,2009,31,29,14,96,0,150,320
RAJASTHAN,BHARATPUR,2009,82,131,35,39,0,437,724
RAJASTHAN,BHILWARA,2009,52,87,7,97,0,518,761
RAJASTHAN,BIKANER,2009,37,36,11,83,0,353,520
RAJASTHAN,BUNDI,2009,37,93,5,138,0,270,543
RAJASTHAN,CHITTORGARH,2009,44,70,7,82,0,463,666
RAJASTHAN,CHURU,2009,33,22,11,19,0,296,381
RAJASTHAN,DAUSA,2009,13,62,14,19,0,144,252
RAJASTHAN,DHOLPUR,2009,30,52,32,19,0,180,313
RAJASTHAN,DUNGARPUR,2009,29,36,11,47,0,97,220
RAJASTHAN,G.R.P.,2009,1,1,2,9,0,0,13
RAJASTHAN,GANGANAGAR,2009,89,56,13,61,1,646,866
RAJASTHAN,HANUMANGARH,2009,54,43,16,60,0,266,439
RAJASTHAN,JAIPUR EAST,2009,29,55,6,53,0,179,322
RAJASTHAN,JAIPUR NORTH,2009,23,72,9,31,0,202,337
RAJASTHAN,JAIPUR RURAL,2009,49,85,14,94,3,256,501
RAJASTHAN,JAIPUR SOUTH,2009,17,62,5,18,0,192,294
RAJASTHAN,JAISALMER,2009,5,9,5,18,0,23,60
RAJASTHAN,JALORE,2009,19,26,9,39,0,142,235
RAJASTHAN,JHALAWAR,2009,55,45,7,215,3,379,704
RAJASTHAN,JHUNJHUNU,2009,41,50,13,39,0,280,423
RAJASTHAN,JODHPUR CITY,2009,15,55,9,40,1,242,362
RAJASTHAN,JODHPUR RURAL,2009,27,29,19,43,0,97,215
RAJASTHAN,KARAULI,2009,46,49,14,25,0,138,272
RAJASTHAN,KOTA CITY,2009,23,76,7,51,0,376,533
RAJASTHAN,KOTA RURAL,2009,29,32,4,99,3,230,397
RAJASTHAN,NAGAUR,2009,53,76,6,117,0,302,554
RAJASTHAN,PALI,2009,48,92,8,77,4,403,632
RAJASTHAN,PRATAPGARH,2009,54,59,2,50,0,180,345
RAJASTHAN,RAJSAMAND,2009,11,42,3,46,2,205,309
RAJASTHAN,SAWAI MADHOPUR,2009,17,66,10,18,0,171,282
RAJASTHAN,SIKAR,2009,36,59,21,18,0,323,457
RAJASTHAN,SIROHI,2009,18,25,4,64,1,132,244
RAJASTHAN,TONK,2009,20,42,4,26,0,252,344
RAJASTHAN,UDAIPUR,2009,109,156,15,159,4,353,796
RAJASTHAN,TOTAL,2009,1519,2310,436,2485,24,10371,17145
SIKKIM,EAST,2009,5,2,0,4,0,4,15
SIKKIM,NORTH,2009,0,0,0,0,0,0,0
SIKKIM,SOUTH,2009,8,2,0,5,0,1,16
SIKKIM,WEST,2009,5,2,0,1,0,1,9
SIKKIM,TOTAL,2009,18,6,0,10,0,6,40
TAMIL NADU,ARIYALUR,2009,21,15,3,39,1,7,86
TAMIL NADU,CHENNAI,2009,39,37,19,42,10,154,301
TAMIL NADU,CHENNAI RLY.,2009,0,0,2,5,1,0,8
TAMIL NADU,CHENNAISUBURBAN,2009,46,18,20,51,65,59,259
TAMIL NADU,COIMBATORE RURAL,2009,7,24,4,41,12,56,144
TAMIL NADU,COIMBATORE URBAN,2009,9,9,4,21,3,48,94
TAMIL NADU,CUDDALORE,2009,20,34,13,32,0,39,138
TAMIL NADU,DHARMAPURI,2009,7,30,6,56,5,34,138
TAMIL NADU,DINDIGUL,2009,10,61,1,34,1,87,194
TAMIL NADU,ERODE,2009,16,37,1,31,9,12,106
TAMIL NADU,KANCHIPURAM,2009,28,11,10,12,0,22,83
TAMIL NADU,KANYAKUMARI,2009,11,31,9,23,45,65,184
TAMIL NADU,KARUR,2009,7,10,2,13,7,14,53
TAMIL NADU,KRISHNAGIRI,2009,15,31,1,31,3,24,105
TAMIL NADU,MADURAI RURAL,2009,18,39,9,75,17,82,240
TAMIL NADU,MADURAI URBAN,2009,3,10,4,7,19,67,110
TAMIL NADU,NAGAPATTINAM,2009,7,36,5,31,7,25,111
TAMIL NADU,NAMAKKAL,2009,14,28,1,39,17,16,115
TAMIL NADU,NILGIRIS,2009,3,5,0,11,0,4,23
TAMIL NADU,PERAMBALUR,2009,11,11,4,14,3,2,45
TAMIL NADU,PUDUKOTTAI,2009,5,22,4,21,1,18,71
TAMIL NADU,RAMNATHAPURAM,2009,10,52,1,22,2,23,110
TAMIL NADU,SALEM RURAL,2009,32,81,3,90,0,50,256
TAMIL NADU,SALEM URBAN,2009,20,19,3,13,7,40,102
TAMIL NADU,SIVAGANGAI,2009,5,23,1,11,9,30,79
TAMIL NADU,THANJAVUR,2009,5,36,8,60,3,17,129
TAMIL NADU,THENI,2009,9,40,7,50,29,66,201
TAMIL NADU,THIRUNELVELI RURAL,2009,44,55,5,91,0,65,260
TAMIL NADU,THIRUNELVELI URBAN,2009,5,24,1,7,0,6,43
TAMIL NADU,THIRUVALLUR,2009,12,19,6,15,0,26,78
TAMIL NADU,THIRUVANNAMALAI,2009,12,19,3,18,0,29,81
TAMIL NADU,THIRUVARUR,2009,1,15,0,21,0,8,45
TAMIL NADU,THOOTHUGUDI,2009,20,30,3,3,0,35,91
TAMIL NADU,TIRUPPUR,2009,12,42,3,46,8,46,157
TAMIL NADU,TRICHY RLY.,2009,0,0,0,2,0,0,2
TAMIL NADU,TRICHY RURAL,2009,10,16,6,24,0,27,83
TAMIL NADU,TRICHY URBAN,2009,6,16,0,11,98,24,155
TAMIL NADU,VELLORE,2009,18,40,10,21,1,31,121
TAMIL NADU,VILLUPURAM,2009,62,66,8,78,31,33,278
TAMIL NADU,VIRUDHUNAGAR,2009,16,41,4,30,87,69,247
TAMIL NADU,TOTAL,2009,596,1133,194,1242,501,1460,5126
TRIPURA,DHALAI,2009,18,4,1,16,0,47,86
TRIPURA,NORTH,2009,48,23,6,78,0,174,329
TRIPURA,SOUTH,2009,48,21,8,153,1,192,423
TRIPURA,WEST,2009,76,44,14,137,4,402,677
TRIPURA,TOTAL,2009,190,92,29,384,5,815,1515
UTTAR PRADESH,AGRA,2009,40,185,83,97,85,381,871
UTTAR PRADESH,ALIGARH,2009,58,214,54,109,48,294,777
UTTAR PRADESH,ALLAHABAD,2009,38,126,70,59,51,289,633
UTTAR PRADESH,AMBEDKAR NAGAR,2009,19,49,15,9,19,102,213
UTTAR PRADESH,AURAIYA,2009,11,35,26,20,16,30,138
UTTAR PRADESH,AZAMGARH,2009,17,64,31,26,31,83,252
UTTAR PRADESH,BADAUN,2009,29,67,43,28,18,55,240
UTTAR PRADESH,BAGHPAT,2009,15,45,16,6,20,72,174
UTTAR PRADESH,BAHRAICH,2009,38,86,32,33,27,72,288
UTTAR PRADESH,BALLIA,2009,9,25,31,19,9,53,146
UTTAR PRADESH,BALRAMPUR,2009,8,23,10,11,6,34,92
UTTAR PRADESH,BANDA,2009,23,32,24,42,11,44,176
UTTAR PRADESH,BARABANKI,2009,19,106,39,34,50,104,352
UTTAR PRADESH,BAREILLY,2009,77,153,47,125,96,303,801
UTTAR PRADESH,BASTI,2009,12,22,15,3,0,12,64
UTTAR PRADESH,BIJNOR,2009,30,75,22,46,44,225,442
UTTAR PRADESH,BULANDSHAHAR,2009,38,81,53,36,24,184,416
UTTAR PRADESH,CHANDOLI,2009,3,18,13,4,4,88,130
UTTAR PRADESH,CHITRAKOOT DHAM,2009,20,10,9,22,1,12,74
UTTAR PRADESH,DEORIA,2009,9,38,30,15,12,32,136
UTTAR PRADESH,ETAH,2009,18,45,42,37,13,92,247
UTTAR PRADESH,ETAWAH,2009,5,62,35,42,39,112,295
UTTAR PRADESH,FAIZABAD,2009,22,69,18,27,21,38,195
UTTAR PRADESH,FATEHGARH,2009,17,61,23,30,16,61,208
UTTAR PRADESH,FATEHPUR,2009,28,44,38,39,13,51,213
UTTAR PRADESH,FIROZABAD,2009,26,95,47,59,35,130,392
UTTAR PRADESH,G.R.P.,2009,1,0,1,10,57,0,69
UTTAR PRADESH,GAUTAMBUDH NAGAR,2009,24,60,22,40,46,103,295
UTTAR PRADESH,GHAZIABAD,2009,53,321,66,88,182,556,1266
UTTAR PRADESH,GHAZIPUR,2009,3,16,29,12,22,63,145
UTTAR PRADESH,GONDA,2009,29,74,42,28,12,3,188
UTTAR PRADESH,GORAKHPUR,2009,43,94,50,44,47,255,533
UTTAR PRADESH,HAMIRPUR,2009,16,18,20,21,9,22,106
UTTAR PRADESH,HARDOI,2009,29,87,45,61,13,73,308
UTTAR PRADESH,HATHRAS,2009,22,52,23,33,8,146,284
UTTAR PRADESH,J.P.NAGAR,2009,26,36,16,21,39,69,207
UTTAR PRADESH,JALAUN,2009,11,27,34,41,15,43,171
UTTAR PRADESH,JAUNPUR,2009,18,68,47,30,25,136,324
UTTAR PRADESH,JHANSI,2009,14,36,27,33,35,9,154
UTTAR PRADESH,KANNAUJ,2009,8,48,25,28,8,85,202
UTTAR PRADESH,KANPUR DEHAT,2009,17,82,22,34,16,113,284
UTTAR PRADESH,KANPUR NAGAR,2009,40,227,73,109,210,551,1210
UTTAR PRADESH,KANSHIRAM NAGAR,2009,15,30,29,22,5,26,127
UTTAR PRADESH,KAUSHAMBI,2009,15,30,27,49,12,86,219
UTTAR PRADESH,KHIRI,2009,37,83,40,59,36,68,323
UTTAR PRADESH,KUSHI NAGAR,2009,9,18,22,7,5,21,82
UTTAR PRADESH,LALITPUR,2009,13,9,8,19,12,25,86
UTTAR PRADESH,LUCKNOW,2009,56,306,53,178,256,664,1513
UTTAR PRADESH,MAHARAJGANJ,2009,17,28,17,12,13,38,125
UTTAR PRADESH,MAHOBA,2009,11,22,17,26,6,15,97
UTTAR PRADESH,MAINPURI,2009,16,64,36,38,20,30,204
UTTAR PRADESH,MATHURA,2009,20,59,25,42,42,197,385
UTTAR PRADESH,MAU,2009,15,46,10,22,31,60,184
UTTAR PRADESH,MEERUT,2009,46,141,41,47,123,361,759
UTTAR PRADESH,MIRZAPUR,2009,11,12,19,9,4,178,233
UTTAR PRADESH,MORADABAD,2009,69,159,32,63,61,264,648
UTTAR PRADESH,MUZAFFARNAGAR,2009,58,138,27,64,86,340,713
UTTAR PRADESH,PILIBHIT,2009,15,56,27,37,15,186,336
UTTAR PRADESH,PRATAPGARH,2009,22,73,27,35,12,99,268
UTTAR PRADESH,RAIBAREILLY,2009,30,59,29,46,41,114,319
UTTAR PRADESH,RAMPUR,2009,51,90,24,48,16,3,232
UTTAR PRADESH,SAHARANPUR,2009,14,36,35,29,39,139,292
UTTAR PRADESH,SANT KABIRNAGAR,2009,13,29,9,9,15,2,77
UTTAR PRADESH,SHAHJAHANPUR,2009,43,105,54,53,16,11,282
UTTAR PRADESH,SHRAWASTI,2009,8,23,9,27,4,28,99
UTTAR PRADESH,SIDHARTHNAGAR,2009,9,29,14,23,6,20,101
UTTAR PRADESH,SITAPUR,2009,61,144,75,74,47,84,485
UTTAR PRADESH,SONBHADRA,2009,25,25,11,16,20,36,133
UTTAR PRADESH,ST.RAVIDASNAGAR,2009,3,5,10,9,7,24,58
UTTAR PRADESH,SULTANPUR,2009,16,63,28,35,35,60,237
UTTAR PRADESH,UNNAO,2009,48,85,40,61,14,100,348
UTTAR PRADESH,VARANASI,2009,10,35,29,12,72,107,265
UTTAR PRADESH,TOTAL,2009,1759,5078,2232,2782,2524,8566,22941
UTTARAKHAND,ALMORA,2009,4,5,4,4,0,11,28
UTTARAKHAND,BAGESHWAR,2009,3,1,2,1,1,2,10
UTTARAKHAND,CHAMOLI,2009,1,0,0,2,0,2,5
UTTARAKHAND,CHAMPAWAT,2009,1,2,2,5,0,0,10
UTTARAKHAND,DEHRADUN,2009,30,60,11,30,110,133,374
UTTARAKHAND,HARIDWAR,2009,26,60,22,30,112,107,357
UTTARAKHAND,NAINITAL,2009,14,37,23,14,17,19,124
UTTARAKHAND,PAURI GARHWAL,2009,4,13,6,3,4,9,39
UTTARAKHAND,PITHORAGARH,2009,0,1,1,3,0,4,9
UTTARAKHAND,RUDRA PRAYAG,2009,2,2,3,0,2,4,13
UTTARAKHAND,TEHRI GARHWAL,2009,1,3,1,3,0,2,10
UTTARAKHAND,UDHAMSINGH NAGAR,2009,21,58,19,21,0,65,184
UTTARAKHAND,UTTARKASHI,2009,4,5,0,3,3,3,18
UTTARAKHAND,TOTAL,2009,111,247,94,119,249,361,1181
WEST BENGAL,24 PARGANAS NORTH,2009,166,249,54,203,3,2225,2900
WEST BENGAL,24 PARGANAS SOUTH,2009,280,128,63,120,1,2542,3134
WEST BENGAL,ASANSOL,2009,13,17,17,14,0,211,272
WEST BENGAL,BANKURA,2009,33,31,28,46,1,172,311
WEST BENGAL,BIRBHUM,2009,52,49,18,60,0,298,477
WEST BENGAL,BURDWAN,2009,55,12,30,25,9,710,841
WEST BENGAL,COOCHBEHAR,2009,139,139,13,76,0,508,875
WEST BENGAL,DAKSHIN DINAJPUR,2009,49,51,7,76,1,211,395
WEST BENGAL,DARJEELING,2009,54,40,2,55,2,141,294
WEST BENGAL,HOOGHLY,2009,48,79,25,24,0,629,805
WEST BENGAL,HOWRAH,2009,39,112,21,76,0,743,991
WEST BENGAL,HOWRAH G.R.P.,2009,1,1,1,2,0,1,6
WEST BENGAL,JALPAIGURI,2009,193,177,11,136,0,646,1163
WEST BENGAL,KHARAGPUR G.R.P.,2009,0,0,0,0,0,3,3
WEST BENGAL,KOLKATA,2009,42,107,10,201,90,411,861
WEST BENGAL,MALDA,2009,197,132,10,131,0,567,1037
WEST BENGAL,MURSHIDABAD,2009,568,342,51,348,1,3035,4345
WEST BENGAL,NADIA,2009,175,276,44,118,0,1508,2121
WEST BENGAL,PASCHIM MIDNAPUR,2009,57,79,31,83,0,567,817
WEST BENGAL,PURAB MIDNAPUR,2009,41,74,40,33,0,475,663
WEST BENGAL,PURULIA,2009,53,0,9,30,0,170,262
WEST BENGAL,SEALDAH G.R.P.,2009,1,6,3,7,0,5,22
WEST BENGAL,SILIGURI G.R.P.,2009,0,1,0,3,0,0,4
WEST BENGAL,UTTAR DINAJPUR,2009,80,85,18,75,0,334,592
WEST BENGAL,TOTAL,2009,2336,2187,506,1942,108,16112,23191
A & N ISLANDS,ANDAMAN,2009,18,14,1,29,7,21,90
A & N ISLANDS,NICOBAR,2009,0,0,0,1,0,0,1
A & N ISLANDS,TOTAL,2009,18,14,1,30,7,21,91
CHANDIGARH,CHANDIGARH,2009,29,36,2,26,2,51,146
CHANDIGARH,TOTAL,2009,29,36,2,26,2,51,146
D & N HAVELI,D and N HAVELI,2009,4,9,0,2,1,3,19
D & N HAVELI,TOTAL,2009,4,9,0,2,1,3,19
DAMAN & DIU,DAMAN,2009,1,0,0,4,1,1,7
DAMAN & DIU,DIU,2009,0,0,0,0,0,2,2
DAMAN & DIU,TOTAL,2009,1,0,0,4,1,3,9
DELHI,CAW,2009,0,0,0,1,0,192,193
DELHI,CENTRAL,2009,28,49,6,34,5,62,184
DELHI,CRIME BRANCH,2009,2,0,0,0,0,0,2
DELHI,DELHI UT TOTAL,2009,469,1655,141,552,118,1283,4218
DELHI,EAST,2009,52,187,10,81,10,121,461
DELHI,EOW,2009,0,0,0,1,1,0,2
DELHI,GRP(RLY),2009,4,5,1,0,0,1,11
DELHI,IGI AIRPORT,2009,0,0,0,2,0,0,2
DELHI,NEW DELHI,2009,6,17,1,17,7,7,55
DELHI,NORTH,2009,19,81,8,35,18,49,210
DELHI,NORTH-EAST,2009,47,246,15,67,9,138,522
DELHI,NORTH-WEST,2009,54,137,13,39,0,120,363
DELHI,OUTER,2009,41,204,21,61,6,173,506
DELHI,SOUTH,2009,42,97,10,45,23,61,278
DELHI,SOUTH-EAST,2009,59,237,18,78,30,63,485
DELHI,SOUTH-WEST,2009,52,170,17,53,3,79,374
DELHI,STF,2009,0,0,0,0,0,0,0
DELHI,WEST,2009,63,225,21,38,6,217,570
LAKSHADWEEP,LAKSHADWEEP,2009,1,0,0,0,0,0,1
LAKSHADWEEP,TOTAL,2009,1,0,0,0,0,0,1
PUDUCHERRY,KARAIKAL,2009,0,1,0,16,2,0,19
PUDUCHERRY,PUDUCHERRY,2009,1,12,0,37,14,10,74
PUDUCHERRY,TOTAL,2009,1,13,0,53,16,10,93
ANDHRA PRADESH,ADILABAD,2010,48,48,18,133,155,429,831
ANDHRA PRADESH,ANANTAPUR,2010,20,60,20,132,35,250,517
ANDHRA PRADESH,CHITTOOR,2010,44,56,32,136,121,388,777
ANDHRA PRADESH,CUDDAPAH,2010,39,51,15,137,45,321,608
ANDHRA PRADESH,CYBERABAD,2010,95,72,43,157,1257,1191,2815
ANDHRA PRADESH,EAST GODAVARI,2010,66,30,20,193,188,246,743
ANDHRA PRADESH,GUNTAKAL RLY.,2010,0,2,0,2,2,0,6
ANDHRA PRADESH,GUNTUR,2010,38,39,20,282,409,456,1244
ANDHRA PRADESH,GUNTUR URBAN,2010,12,5,13,48,54,245,377
ANDHRA PRADESH,HYDERABAD CITY,2010,45,41,44,171,60,1420,1781
ANDHRA PRADESH,KARIMNAGAR,2010,65,128,39,237,241,636,1346
ANDHRA PRADESH,KHAMMAM,2010,62,66,17,147,129,354,775
ANDHRA PRADESH,KRISHNA,2010,54,67,22,300,149,412,1004
ANDHRA PRADESH,KURNOOL,2010,49,67,19,347,268,501,1251
ANDHRA PRADESH,MAHABOOBNAGAR,2010,89,78,34,174,78,233,686
ANDHRA PRADESH,MEDAK,2010,49,68,29,103,95,316,660
ANDHRA PRADESH,NALGONDA,2010,68,81,32,195,192,218,786
ANDHRA PRADESH,NELLORE,2010,28,74,6,176,119,382,785
ANDHRA PRADESH,NIZAMABAD,2010,62,50,21,114,75,626,948
ANDHRA PRADESH,PRAKASHAM,2010,29,65,13,253,32,216,608
ANDHRA PRADESH,RAJAHMUNDRY,2010,10,12,4,47,39,96,208
ANDHRA PRADESH,RANGA REDDY,2010,19,19,19,39,26,75,197
ANDHRA PRADESH,SECUNDERABAD RLY.,2010,1,1,0,2,2,0,6
ANDHRA PRADESH,SRIKAKULAM,2010,35,31,5,93,92,233,489
ANDHRA PRADESH,TIRUPATHI URBAN,2010,10,15,5,38,25,85,178
ANDHRA PRADESH,VIJAYAWADA CITY,2010,25,65,17,172,219,626,1124
ANDHRA PRADESH,VIJAYAWADA RLY.,2010,1,0,3,6,0,4,14
ANDHRA PRADESH,VISAKHA RURAL,2010,42,12,8,92,52,222,428
ANDHRA PRADESH,VISAKHAPATNAM,2010,53,24,11,59,52,393,592
ANDHRA PRADESH,VIZIANAGARAM,2010,32,15,14,101,85,312,559
ANDHRA PRADESH,WARANGAL,2010,28,39,7,98,10,50,232
ANDHRA PRADESH,WARANGAL URBAN,2010,17,28,12,50,25,412,544
ANDHRA PRADESH,WEST GODAVARI,2010,127,122,26,400,231,732,1638
ANDHRA PRADESH,TOTAL,2010,1362,1531,588,4634,4562,12080,24757
ARUNACHAL PRADESH,ANJAW,2010,1,0,0,0,0,2,3
ARUNACHAL PRADESH,CHANGLANG,2010,4,4,0,10,0,1,19
ARUNACHAL PRADESH,DIBANG VALLEY,2010,3,3,0,2,0,0,8
ARUNACHAL PRADESH,K/KUMEY,2010,0,1,0,0,0,0,1
ARUNACHAL PRADESH,KAMENG EAST,2010,1,3,0,2,0,0,6
ARUNACHAL PRADESH,KAMENG WEST,2010,0,3,0,5,0,0,8
ARUNACHAL PRADESH,LOHIT,2010,9,3,0,7,0,0,19
ARUNACHAL PRADESH,PAPUM PARE,2010,4,9,0,13,0,1,27
ARUNACHAL PRADESH,RURAL,2010,3,2,0,5,0,0,10
ARUNACHAL PRADESH,SIANG EAST,2010,8,5,0,8,0,0,21
ARUNACHAL PRADESH,SIANG UPPER,2010,1,1,0,2,0,0,4
ARUNACHAL PRADESH,SIANG WEST,2010,6,6,0,16,1,5,34
ARUNACHAL PRADESH,SUBANSIRI LOWER,2010,0,2,0,4,0,0,6
ARUNACHAL PRADESH,SUBANSIRI UPPER,2010,5,4,0,7,0,3,19
ARUNACHAL PRADESH,TAWANG,2010,1,0,0,1,0,0,2
ARUNACHAL PRADESH,TIRAP,2010,1,0,0,2,0,0,3
ARUNACHAL PRADESH,UPPER DIBANG VALLEY,2010,0,0,0,0,0,0,0
ARUNACHAL PRADESH,TOTAL,2010,47,46,0,84,1,12,190
ASSAM,BARPETA,2010,109,155,12,65,0,197,538
ASSAM,BASKA,2010,23,42,5,14,0,24,108
ASSAM,BONGAIGAON,2010,51,65,14,46,0,222,398
ASSAM,C.I.D.,2010,0,0,0,0,0,0,0
ASSAM,CACHAR,2010,73,153,15,10,0,504,755
ASSAM,CHIRANG,2010,28,42,2,3,0,55,130
ASSAM,DARRANG,2010,97,123,4,225,0,378,827
ASSAM,DHEMAJI,2010,75,76,5,40,0,122,318
ASSAM,DHUBRI,2010,181,224,16,250,7,719,1397
ASSAM,DIBRUGARH,2010,54,31,6,51,0,152,294
ASSAM,G.R.P.,2010,0,7,0,0,0,1,8
ASSAM,GOALPARA,2010,119,117,4,10,0,263,513
ASSAM,GOLAGHAT,2010,40,84,9,33,0,148,314
ASSAM,GUWAHATI CITY,2010,70,322,12,119,0,218,741
ASSAM,HAILAKANDI,2010,72,54,3,16,0,129,274
ASSAM,JORHAT,2010,51,51,0,60,0,163,325
ASSAM,KAMRUP,2010,51,111,5,69,0,159,395
ASSAM,KARBI ANGLONG,2010,19,27,0,7,0,29,82
ASSAM,KARIMGANJ,2010,36,47,10,7,0,141,241
ASSAM,KOKRAJHAR,2010,30,58,1,3,0,86,178
ASSAM,LAKHIMPUR,2010,39,109,0,60,0,229,437
ASSAM,MORIGAON,2010,74,88,3,63,0,110,338
ASSAM,N.C.HILLS,2010,3,8,2,0,4,2,19
ASSAM,NAGAON,2010,148,293,15,18,9,769,1252
ASSAM,NALBARI,2010,24,51,0,75,0,51,201
ASSAM,R.P.O.,2010,7,2,0,0,0,0,9
ASSAM,SIBSAGAR,2010,75,127,2,85,0,101,390
ASSAM,SONITPUR,2010,80,169,13,30,0,294,586
ASSAM,TINSUKIA,2010,55,107,16,25,0,100,303
ASSAM,UDALGURI,2010,37,24,1,16,0,44,122
ASSAM,TOTAL,2010,1721,2767,175,1400,20,5410,11493
BIHAR,ARARIA,2010,42,63,26,2,0,26,159
BIHAR,ARWAL,2010,3,11,15,4,0,5,38
BIHAR,AURANGABAD,2010,12,55,24,3,0,97,191
BIHAR,BAGAHA,2010,10,51,10,29,0,21,121
BIHAR,BANKA,2010,13,47,24,3,0,23,110
BIHAR,BEGUSARAI,2010,20,45,42,10,0,41,158
BIHAR,BETTIAH,2010,18,88,33,6,0,51,196
BIHAR,BHABHUA,2010,6,35,27,0,0,16,84
BIHAR,BHAGALPUR,2010,22,80,20,12,0,42,176
BIHAR,BHOJPUR,2010,15,55,50,3,0,181,304
BIHAR,BUXAR,2010,12,40,17,15,1,40,125
BIHAR,DARBHANGA,2010,18,87,23,68,0,151,347
BIHAR,GAYA,2010,22,82,42,3,0,97,246
BIHAR,GOPALGANJ,2010,18,85,48,0,0,125,276
BIHAR,JAMALPUR RLY.,2010,0,3,0,3,0,0,6
BIHAR,JAMUI,2010,20,29,17,33,0,48,147
BIHAR,JEHANABAD,2010,8,11,33,10,0,30,92
BIHAR,KATIHAR,2010,55,87,20,6,0,55,223
BIHAR,KATIHAR RLY.,2010,1,2,0,4,0,2,9
BIHAR,KHAGARIA,2010,5,28,22,14,0,20,89
BIHAR,KISHANGANJ,2010,24,38,4,0,0,41,107
BIHAR,LAKHISARAI,2010,10,15,14,4,0,30,73
BIHAR,MADHEPURA,2010,11,52,13,9,0,25,110
BIHAR,MADHUBANI,2010,30,131,31,6,0,90,288
BIHAR,MOTIHARI,2010,25,130,32,0,0,46,233
BIHAR,MUNGER,2010,11,68,14,3,0,43,139
BIHAR,MUZAFFARPUR,2010,52,187,64,7,0,56,366
BIHAR,MUZAFFARPUR RLY.,2010,1,2,0,0,0,0,3
BIHAR,NALANDA,2010,26,74,62,30,0,60,252
BIHAR,NAUGACHIA,2010,8,21,12,23,0,47,111
BIHAR,NAWADAH,2010,11,45,23,3,0,37,119
BIHAR,PATNA,2010,50,148,95,12,3,316,624
BIHAR,PATNA RLY.,2010,1,5,6,17,0,2,31
BIHAR,PURNEA,2010,40,88,16,22,1,60,227
BIHAR,ROHTAS,2010,27,95,45,49,11,31,258
BIHAR,SAHARSA,2010,7,17,9,39,0,22,94
BIHAR,SAMASTIPUR,2010,36,9,62,7,0,42,156
BIHAR,SARAN,2010,23,107,78,24,0,103,335
BIHAR,SHEIKHPURA,2010,2,13,5,0,0,10,30
BIHAR,SHEOHAR,2010,3,12,2,2,0,8,27
BIHAR,SITAMARHI,2010,9,40,28,18,0,25,120
BIHAR,SIWAN,2010,19,105,63,10,0,41,238
BIHAR,SUPAUL,2010,19,38,12,6,0,8,83
BIHAR,VAISHALI,2010,30,145,74,15,0,57,321
BIHAR,TOTAL,2010,795,2569,1257,534,16,2271,7442
CHHATTISGARH,BALRAMPUR,2010,61,0,1,71,29,0,162
CHHATTISGARH,BILASPUR,2010,69,26,20,167,18,130,430
CHHATTISGARH,BIZAPUR,2010,3,3,0,0,0,6,12
CHHATTISGARH,DANTEWARA,2010,9,6,2,8,0,5,30
CHHATTISGARH,DHAMTARI,2010,40,5,2,55,6,18,126
CHHATTISGARH,DURG,2010,106,35,14,269,36,118,578
CHHATTISGARH,GRP RAIPUR,2010,1,2,0,3,0,1,7
CHHATTISGARH,JAGDALPUR,2010,48,15,4,33,4,23,127
CHHATTISGARH,JANJGIR,2010,39,8,14,90,6,100,257
CHHATTISGARH,JASHPUR,2010,69,21,0,53,4,26,173
CHHATTISGARH,KABIRDHAM,2010,19,7,2,85,7,18,138
CHHATTISGARH,KANKER,2010,18,5,2,27,2,8,62
CHHATTISGARH,KORBA,2010,32,6,10,80,4,40,172
CHHATTISGARH,KORIYA,2010,58,21,3,98,9,48,237
CHHATTISGARH,MAHASAMUND,2010,26,6,7,65,5,13,122
CHHATTISGARH,NARAYANPUR,2010,3,2,0,5,0,2,12
CHHATTISGARH,RAIGARH,2010,52,19,10,89,7,45,222
CHHATTISGARH,RAIPUR,2010,136,39,7,268,33,125,608
CHHATTISGARH,RAJNANDGAON,2010,43,15,9,72,5,41,185
CHHATTISGARH,SARGUJA,2010,103,25,3,99,1,40,271
CHHATTISGARH,SURAJPUR,2010,77,13,5,69,6,54,224
CHHATTISGARH,TOTAL,2010,1012,279,115,1706,182,861,4155
GOA,NORTH GOA,2010,12,7,1,24,10,9,63
GOA,SOUTH GOA,2010,24,11,0,12,6,8,61
GOA,TOTAL,2010,36,18,1,36,16,17,124
GUJARAT,AHMEDABAD COMMR.,2010,49,177,12,73,9,1230,1550
GUJARAT,AHMEDABAD RURAL,2010,8,41,0,14,0,113,176
GUJARAT,AHWA-DANG,2010,1,0,0,0,0,2,3
GUJARAT,AMRELI,2010,10,61,0,25,9,162,267
GUJARAT,ANAND,2010,15,39,0,27,3,190,274
GUJARAT,BHARUCH,2010,9,23,0,18,4,2,56
GUJARAT,BHAVNAGAR,2010,8,58,0,32,42,177,317
GUJARAT,CID CRIME,2010,1,0,0,0,0,0,1
GUJARAT,DAHOD,2010,3,51,0,15,0,7,76
GUJARAT,GANDHINAGAR,2010,13,27,1,11,4,152,208
GUJARAT,HIMATNAGAR,2010,18,50,0,26,2,240,336
GUJARAT,JAMNAGAR,2010,14,25,0,27,2,232,300
GUJARAT,JUNAGADH,2010,19,63,0,37,8,443,570
GUJARAT,KHEDA NORTH,2010,16,59,0,28,0,200,303
GUJARAT,KUTCH,2010,8,31,0,18,1,227,285
GUJARAT,MEHSANA,2010,8,58,0,27,0,241,334
GUJARAT,NARMADA,2010,7,4,0,8,0,5,24
GUJARAT,NAVSARI,2010,6,15,0,5,1,34,61
GUJARAT,PALANPUR,2010,38,108,1,59,5,293,504
GUJARAT,PANCHMAHAL,2010,13,58,0,31,0,188,290
GUJARAT,PATAN,2010,11,37,0,32,1,101,182
GUJARAT,PORBANDAR,2010,2,9,1,4,3,69,88
GUJARAT,RAJKOT COMMR.,2010,12,32,0,14,7,294,359
GUJARAT,RAJKOT RURAL,2010,24,60,1,22,5,253,365
GUJARAT,SURAT COMMR.,2010,23,63,3,24,1,268,382
GUJARAT,SURAT RURAL,2010,6,23,0,4,0,28,61
GUJARAT,SURENDRANAGAR,2010,29,27,0,36,2,113,207
GUJARAT,TAPI,2010,3,1,0,7,0,17,28
GUJARAT,VADODARA COMMR.,2010,7,30,0,18,0,216,271
GUJARAT,VADODARA RURAL,2010,16,50,0,18,0,85,169
GUJARAT,VALSAD,2010,11,8,0,4,0,15,38
GUJARAT,W.RLY,2010,0,2,0,4,1,3,10
GUJARAT,TOTAL,2010,408,1290,19,668,110,5600,8095
HARYANA,AMBALA,2010,30,23,9,20,14,220,316
HARYANA,BHIWANI,2010,30,36,22,45,15,64,212
HARYANA,FARIDABAD,2010,51,86,23,27,78,224,489
HARYANA,FATEHABAD,2010,21,31,5,13,9,79,158
HARYANA,GRP,2010,1,2,5,8,144,0,160
HARYANA,GURGAON,2010,45,42,22,30,38,86,263
HARYANA,HISSAR,2010,25,65,13,24,17,261,405
HARYANA,JHAJJAR,2010,36,30,12,27,30,117,252
HARYANA,JIND,2010,29,26,17,27,20,88,207
HARYANA,KAITHAL,2010,28,20,11,15,0,112,186
HARYANA,KARNAL,2010,52,20,21,29,22,231,375
HARYANA,KURUKSHETRA,2010,36,26,13,9,24,79,187
HARYANA,MAHENDRAGARH,2010,28,36,7,25,0,86,182
HARYANA,MEWAT,2010,28,19,5,12,5,150,219
HARYANA,PALWAL,2010,41,27,14,30,0,89,201
HARYANA,PANCHKULA,2010,10,12,1,10,1,98,132
HARYANA,PANIPAT,2010,55,49,13,22,30,175,344
HARYANA,REWARI,2010,25,24,14,16,27,71,177
HARYANA,ROHTAK,2010,51,19,17,26,57,87,257
HARYANA,SIRSA,2010,39,30,8,9,0,125,211
HARYANA,SONIPAT,2010,27,56,26,32,36,123,300
HARYANA,YAMUNANAGAR,2010,32,35,6,20,13,155,261
HARYANA,TOTAL,2010,720,714,284,476,580,2720,5494
HIMACHAL PRADESH,BADDIPOLICEDIST,2010,5,6,0,6,1,4,22
HIMACHAL PRADESH,BILASPUR,2010,15,6,0,37,6,32,96
HIMACHAL PRADESH,CHAMBA,2010,13,21,1,29,1,5,70
HIMACHAL PRADESH,CID,2010,0,0,0,0,0,0,0
HIMACHAL PRADESH,G.R.P.,2010,0,0,0,0,0,0,0
HIMACHAL PRADESH,HAMIRPUR,2010,11,16,0,27,23,17,94
HIMACHAL PRADESH,KANGRA,2010,22,33,0,60,8,53,176
HIMACHAL PRADESH,KINNAUR,2010,2,2,0,2,0,4,10
HIMACHAL PRADESH,KULLU,2010,17,5,0,23,1,9,55
HIMACHAL PRADESH,LAHAUL-SPITI,2010,0,0,0,1,0,3,4
HIMACHAL PRADESH,MANDI,2010,19,15,0,71,13,45,163
HIMACHAL PRADESH,SHIMLA,2010,21,22,0,27,4,29,103
HIMACHAL PRADESH,SIRMAUR,2010,15,12,0,36,5,17,85
HIMACHAL PRADESH,SOLAN,2010,11,11,0,12,1,20,55
HIMACHAL PRADESH,UNA,2010,9,13,1,19,15,37,94
HIMACHAL PRADESH,TOTAL,2010,160,162,2,350,78,275,1027
JAMMU & KASHMIR,ANANTNAG,2010,7,71,0,112,24,3,217
JAMMU & KASHMIR,AWANTIPORA,2010,2,17,0,19,3,0,41
JAMMU & KASHMIR,BANDIPORA,2010,4,42,0,66,9,0,121
JAMMU & KASHMIR,BARAMULLA,2010,7,55,0,68,12,1,143
JAMMU & KASHMIR,BUDGAM,2010,7,67,0,93,34,0,201
JAMMU & KASHMIR,CRIME JAMMU,2010,0,0,0,0,0,0,0
JAMMU & KASHMIR,CRIME KASHMIR,2010,0,0,0,0,0,0,0
JAMMU & KASHMIR,DODA,2010,21,57,0,27,6,21,132
JAMMU & KASHMIR,GANDERBAL,2010,1,15,0,44,0,1,61
JAMMU & KASHMIR,HANDWARA,2010,1,35,0,47,7,1,91
JAMMU & KASHMIR,JAMMU,2010,36,78,6,36,42,70,268
JAMMU & KASHMIR,KARGIL,2010,0,1,0,0,0,0,1
JAMMU & KASHMIR,KATHUA,2010,17,17,2,26,4,5,71
JAMMU & KASHMIR,KISHTWAR,2010,3,23,0,5,0,5,36
JAMMU & KASHMIR,KULGAM,2010,4,40,0,60,5,1,110
JAMMU & KASHMIR,KUPWARA,2010,3,30,0,21,4,1,59
JAMMU & KASHMIR,LEH,2010,2,3,0,3,0,0,8
JAMMU & KASHMIR,POONCH,2010,20,34,0,30,10,16,110
JAMMU & KASHMIR,PULWAMA,2010,8,31,0,11,13,0,63
JAMMU & KASHMIR,RAILWAYS,2010,0,0,0,0,0,0,0
JAMMU & KASHMIR,RAILWAYS,2010,1,0,0,0,0,0,1
JAMMU & KASHMIR,RAJOURI,2010,36,42,0,26,4,44,152
JAMMU & KASHMIR,RAMBAN,2010,6,17,0,11,2,0,36
JAMMU & KASHMIR,REASI,2010,8,12,0,13,1,0,34
JAMMU & KASHMIR,SAMBA,2010,5,4,1,7,1,6,24
JAMMU & KASHMIR,SHOPIAN,2010,9,45,0,96,5,1,156
JAMMU & KASHMIR,SOPORE,2010,9,34,0,59,13,3,118
JAMMU & KASHMIR,SRINAGAR,2010,13,60,0,130,58,17,278
JAMMU & KASHMIR,UDHAMPUR,2010,15,10,0,28,5,15,73
JAMMU & KASHMIR,TOTAL,2010,245,840,9,1038,262,211,2605
JHARKHAND,BOKARO,2010,28,64,26,2,0,70,190
JHARKHAND,CHAIBASA,2010,48,24,1,7,0,7,87
JHARKHAND,CHATRA,2010,11,21,18,3,0,9,62
JHARKHAND,DEOGHAR,2010,33,17,19,7,2,21,99
JHARKHAND,DHANBAD,2010,32,83,31,30,2,34,212
JHARKHAND,DHANBAD RLY.,2010,1,3,1,11,0,0,16
JHARKHAND,DUMKA,2010,52,27,6,8,0,46,139
JHARKHAND,GARHWA,2010,21,23,10,11,0,38,103
JHARKHAND,GIRIDIH,2010,37,18,39,9,4,63,170
JHARKHAND,GODDA,2010,26,25,7,25,0,11,94
JHARKHAND,GUMLA,2010,57,41,2,8,0,7,115
JHARKHAND,HAZARIBAGH,2010,30,50,27,18,0,42,167
JHARKHAND,JAMSHEDPUR,2010,38,58,15,9,3,55,178
JHARKHAND,JAMSHEDPUR RLY.,2010,0,1,0,1,0,0,2
JHARKHAND,JAMTARA,2010,9,7,2,9,0,0,27
JHARKHAND,KHUNTI,2010,2,2,0,2,0,4,10
JHARKHAND,KODERMA,2010,15,13,8,6,0,21,63
JHARKHAND,LATEHAR,2010,16,14,3,0,0,8,41
JHARKHAND,LOHARDAGGA,2010,39,0,0,0,0,25,64
JHARKHAND,PAKUR,2010,45,15,1,11,0,31,103
JHARKHAND,PALAMU,2010,27,15,23,21,0,22,108
JHARKHAND,RAMGARH,2010,13,16,5,10,2,39,85
JHARKHAND,RANCHI,2010,92,113,22,14,3,53,297
JHARKHAND,SAHEBGANJ,2010,51,29,4,12,0,25,121
JHARKHAND,SARAIKELA,2010,32,12,6,8,0,17,75
JHARKHAND,SIMDEGA,2010,18,5,0,3,0,2,28
JHARKHAND,TOTAL,2010,773,696,276,245,16,650,2656
KARNATAKA,BAGALKOT,2010,9,6,5,67,0,59,146
KARNATAKA,BANGALORE COMMR.,2010,65,29,52,308,50,398,902
KARNATAKA,BANGALORE RURAL,2010,16,18,8,48,0,55,145
KARNATAKA,BELGAUM,2010,42,44,10,222,8,273,599
KARNATAKA,BELLARY,2010,12,15,13,80,0,99,219
KARNATAKA,BIDAR,2010,8,19,6,26,1,88,148
KARNATAKA,BIJAPUR,2010,13,27,5,58,0,160,263
KARNATAKA,CBPURA,2010,9,18,5,34,0,41,107
KARNATAKA,CHAMARAJNAGAR,2010,12,5,3,53,0,52,125
KARNATAKA,CHICKMAGALUR,2010,19,21,11,63,3,90,207
KARNATAKA,CHITRADURGA,2010,26,38,7,158,0,99,328
KARNATAKA,DAKSHIN KANNADA,2010,16,9,1,67,2,62,157
KARNATAKA,DAVANAGERE,2010,16,20,9,91,1,120,257
KARNATAKA,DHARWAD COMMR.,2010,1,13,0,16,3,45,78
KARNATAKA,DHARWAD RURAL,2010,8,11,0,44,0,23,86
KARNATAKA,GADAG,2010,6,0,1,35,0,53,95
KARNATAKA,GULBARGA,2010,34,56,6,56,0,152,304
KARNATAKA,HASSAN,2010,23,25,14,134,0,180,376
KARNATAKA,HAVERI,2010,6,0,2,65,0,65,138
KARNATAKA,K.G.F.,2010,7,14,8,20,0,26,75
KARNATAKA,KODAGU,2010,20,7,1,57,0,61,146
KARNATAKA,KOLAR,2010,12,5,4,29,0,12,62
KARNATAKA,KOPPAL,2010,10,0,2,29,0,46,87
KARNATAKA,MANDYA,2010,30,35,10,117,0,185,377
KARNATAKA,MYSORE COMMR.,2010,7,18,4,22,0,59,110
KARNATAKA,MYSORE RURAL,2010,43,25,13,93,0,161,335
KARNATAKA,RAICHUR,2010,31,32,3,105,0,195,366
KARNATAKA,RAILWAYS,2010,1,0,1,0,0,0,2
KARNATAKA,RAMANAGAR,2010,14,24,22,53,0,76,189
KARNATAKA,SHIMOGA,2010,17,24,4,113,8,277,443
KARNATAKA,TUMKUR,2010,25,14,14,107,0,78,238
KARNATAKA,UDUPI,2010,12,3,1,31,1,38,86
KARNATAKA,UTTAR KANNADA,2010,11,11,0,78,3,66,169
KARNATAKA,YADGIRI,2010,5,0,3,65,3,47,123
KARNATAKA,TOTAL,2010,586,586,248,2544,83,3441,7488
KERALA,ALAPUZHA,2010,40,20,0,176,45,259,540
KERALA,ERNAKULAM COMMR.,2010,20,5,2,67,23,146,263
KERALA,ERNAKULAM RURAL,2010,42,11,1,146,44,203,447
KERALA,IDUKKI,2010,33,4,0,177,13,208,435
KERALA,KANNUR,2010,23,6,0,131,9,300,469
KERALA,KASARGOD,2010,23,1,1,93,28,194,340
KERALA,KOLLAM,2010,55,32,4,364,10,581,1046
KERALA,KOTTAYAM,2010,46,7,0,236,66,257,612
KERALA,KOZHIKODE COMMR.,2010,16,7,1,70,70,164,328
KERALA,KOZHIKODE RURAL,2010,35,14,1,146,12,321,529
KERALA,MALAPPURAM,2010,49,13,0,156,29,658,905
KERALA,PALAKKAD,2010,49,9,4,96,11,352,521
KERALA,PATHANAMTHITTA,2010,29,10,2,132,51,124,348
KERALA,RAILWAYS,2010,0,0,0,12,4,0,16
KERALA,THRISSUR,2010,49,9,1,205,39,400,703
KERALA,TRIVANDRUM COMMR.,2010,27,14,3,194,41,135,414
KERALA,TRIVANDRUM RURAL,2010,68,21,1,476,28,367,961
KERALA,WAYANADU,2010,30,1,1,59,14,128,233
KERALA,TOTAL,2010,634,184,22,2936,537,4797,9110
MADHYA PRADESH,ALIRAJPUR,2010,27,7,1,23,0,10,68
MADHYA PRADESH,ANUPPUR,2010,35,5,12,74,4,54,184
MADHYA PRADESH,ASHOK NAGAR,2010,45,9,8,103,10,59,234
MADHYA PRADESH,BALAGHAT,2010,52,6,4,97,14,40,213
MADHYA PRADESH,BARWANI,2010,32,4,6,56,8,6,112
MADHYA PRADESH,BETUL,2010,144,22,24,152,9,42,393
MADHYA PRADESH,BHIND,2010,30,8,40,60,2,42,182
MADHYA PRADESH,BHOPAL,2010,106,59,31,28,186,205,615
MADHYA PRADESH,BHOPAL RLY.,2010,2,1,4,10,3,0,20
MADHYA PRADESH,BURHANPUR,2010,22,2,11,57,11,18,121
MADHYA PRADESH,CHHATARPUR,2010,55,24,24,184,11,55,353
MADHYA PRADESH,CHHINDWARA,2010,102,14,8,235,38,105,502
MADHYA PRADESH,DAMOH,2010,41,19,25,203,0,84,372
MADHYA PRADESH,DATIYA,2010,27,10,8,75,0,27,147
MADHYA PRADESH,DEWAS,2010,89,26,10,192,41,131,489
MADHYA PRADESH,DHAR,2010,89,41,54,176,22,82,464
MADHYA PRADESH,DINDORI,2010,31,1,4,89,5,17,147
MADHYA PRADESH,GUNA,2010,56,11,13,150,9,47,286
MADHYA PRADESH,GWALIOR,2010,71,82,52,180,18,248,651
MADHYA PRADESH,HARDA,2010,40,9,3,54,5,17,128
MADHYA PRADESH,HOSHANGABAD,2010,73,35,20,140,48,111,427
MADHYA PRADESH,INDORE,2010,104,45,38,338,67,352,944
MADHYA PRADESH,INDORE RLY.,2010,0,1,0,2,1,0,4
MADHYA PRADESH,JABALPUR,2010,130,32,56,189,60,185,652
MADHYA PRADESH,JABALPUR RLY.,2010,5,1,0,1,1,0,8
MADHYA PRADESH,JHABUA,2010,35,12,1,45,0,5,98
MADHYA PRADESH,KATNI,2010,69,10,13,144,18,77,331
MADHYA PRADESH,KHANDWA,2010,46,13,9,154,21,39,282
MADHYA PRADESH,KHARGON,2010,71,14,31,162,28,35,341
MADHYA PRADESH,MANDLA,2010,56,7,5,68,6,17,159
MADHYA PRADESH,MANDSAUR,2010,58,19,4,108,14,59,262
MADHYA PRADESH,MORENA,2010,40,17,32,80,0,75,244
MADHYA PRADESH,NARSINGHPUR,2010,65,5,21,135,12,63,301
MADHYA PRADESH,NEEMUCH,2010,12,11,3,48,7,47,128
MADHYA PRADESH,PANNA,2010,47,5,16,87,0,47,202
MADHYA PRADESH,RAISEN,2010,86,32,16,210,0,65,409
MADHYA PRADESH,RAJGARH,2010,73,27,14,179,27,30,350
MADHYA PRADESH,RATLAM,2010,88,23,16,145,32,94,398
MADHYA PRADESH,REWA,2010,81,43,37,140,1,124,426
MADHYA PRADESH,SAGAR,2010,120,63,35,385,16,133,752
MADHYA PRADESH,SATNA,2010,89,20,26,199,18,119,471
MADHYA PRADESH,SEONI,2010,71,16,18,92,23,38,258
MADHYA PRADESH,SHAHDOL,2010,61,16,12,123,6,63,281
MADHYA PRADESH,SHAJAPUR,2010,56,16,11,117,19,33,252
MADHYA PRADESH,SHEOPUR,2010,11,4,3,35,0,23,76
MADHYA PRADESH,SHIVPURI,2010,73,22,7,131,9,32,274
MADHYA PRADESH,SIDHI,2010,44,28,26,104,3,36,241
MADHYA PRADESH,SIHORE,2010,70,26,10,135,15,89,345
MADHYA PRADESH,SINGRAULI,2010,46,24,15,119,2,85,291
MADHYA PRADESH,TIKAMGARH,2010,78,16,15,143,4,59,315
MADHYA PRADESH,UJJAIN,2010,77,48,20,179,42,193,559
MADHYA PRADESH,UMARIYA,2010,23,1,3,72,0,25,124
MADHYA PRADESH,VIDISHA,2010,81,18,17,239,22,114,491
MADHYA PRADESH,TOTAL,2010,3135,1030,892,6646,918,3756,16377
MAHARASHTRA,AHMEDNAGAR,2010,57,45,10,115,1,604,832
MAHARASHTRA,AKOLA,2010,25,23,12,100,55,149,364
MAHARASHTRA,AMRAVATI COMMR.,2010,20,28,3,52,12,96,211
MAHARASHTRA,AMRAVATI RURAL,2010,40,29,2,179,38,135,423
MAHARASHTRA,AURANGABAD COMMR.,2010,23,30,10,52,39,157,311
MAHARASHTRA,AURANGABAD RURAL,2010,16,12,21,56,14,303,422
MAHARASHTRA,BEED,2010,28,29,11,87,11,360,526
MAHARASHTRA,BHANDARA,2010,24,13,3,42,12,61,155
MAHARASHTRA,BULDHANA,2010,29,18,34,131,40,185,437
MAHARASHTRA,CHANDRAPUR,2010,43,16,7,117,116,147,446
MAHARASHTRA,DHULE,2010,18,12,6,28,9,234,307
MAHARASHTRA,GADCHIROLI,2010,16,9,0,28,0,20,73
MAHARASHTRA,GONDIA,2010,28,15,3,80,27,41,194
MAHARASHTRA,HINGOLI,2010,14,4,1,33,7,115,174
MAHARASHTRA,JALGAON,2010,49,32,11,143,41,425,701
MAHARASHTRA,JALNA,2010,11,11,40,81,10,315,468
MAHARASHTRA,KOLHAPUR,2010,27,13,18,71,12,96,237
MAHARASHTRA,LATUR,2010,28,31,3,85,3,229,379
MAHARASHTRA,MUMBAI COMMR.,2010,194,146,21,475,138,312,1286
MAHARASHTRA,MUMBAI RLY.,2010,2,3,0,15,9,0,29
MAHARASHTRA,NAGPUR COMMR.,2010,58,34,8,87,48,175,410
MAHARASHTRA,NAGPUR RLY.,2010,1,2,0,8,2,0,13
MAHARASHTRA,NAGPUR RURAL,2010,39,26,8,78,19,56,226
MAHARASHTRA,NANDED,2010,36,43,68,85,5,315,552
MAHARASHTRA,NANDURBAR,2010,20,12,2,32,12,88,166
MAHARASHTRA,NASIK COMMR.,2010,30,19,2,46,18,124,239
MAHARASHTRA,NASIK RURAL,2010,53,19,6,79,27,344,528
MAHARASHTRA,NAVI MUMBAI,2010,27,11,3,36,38,89,204
MAHARASHTRA,OSMANABAD,2010,28,23,2,74,11,161,299
MAHARASHTRA,PARBHANI,2010,20,21,5,54,6,209,315
MAHARASHTRA,PUNE COMMR.,2010,91,94,4,78,91,214,572
MAHARASHTRA,PUNE RLY.,2010,0,1,0,1,0,0,2
MAHARASHTRA,PUNE RURAL,2010,72,33,15,136,30,200,486
MAHARASHTRA,RAIGAD,2010,15,7,0,39,10,49,120
MAHARASHTRA,RATNAGIRI,2010,28,7,0,37,12,33,117
MAHARASHTRA,SANGLI,2010,49,10,18,67,10,84,238
MAHARASHTRA,SATARA,2010,27,29,0,82,19,170,327
MAHARASHTRA,SINDHUDURG,2010,9,4,0,10,12,11,46
MAHARASHTRA,SOLAPUR COMMR.,2010,12,10,2,22,2,78,126
MAHARASHTRA,SOLAPUR RURAL,2010,63,34,5,97,35,205,439
MAHARASHTRA,THANE COMMR.,2010,93,61,9,152,32,365,712
MAHARASHTRA,THANE RURAL,2010,47,20,6,95,42,120,330
MAHARASHTRA,WARDHA,2010,44,22,2,119,57,93,337
MAHARASHTRA,WASHIM,2010,12,14,5,56,10,102,199
MAHARASHTRA,YAVATMAL,2010,33,49,7,121,38,165,413
MAHARASHTRA,TOTAL,2010,1599,1124,393,3661,1180,7434,15391
MANIPUR,BISHNUPUR,2010,6,12,0,7,0,4,29
MANIPUR,CHANDEL,2010,0,0,0,0,0,0,0
MANIPUR,CHURACHANDPUR,2010,1,0,0,0,0,0,1
MANIPUR,CID,2010,0,0,0,0,0,0,0
MANIPUR,IMPHAL EAST,2010,6,23,0,4,0,3,36
MANIPUR,IMPHAL WEST,2010,10,45,0,12,0,3,70
MANIPUR,SENAPATI,2010,1,2,0,0,0,0,3
MANIPUR,TAMENGLONG,2010,0,0,0,0,0,0,0
MANIPUR,THOUBAL,2010,9,25,0,8,0,8,50
MANIPUR,UKHRUL,2010,1,0,0,0,0,0,1
MANIPUR,TOTAL,2010,34,107,0,31,0,18,190
MEGHALAYA,GARO HILLS EAST,2010,5,3,0,3,0,0,11
MEGHALAYA,GARO HILLS SOUTH,2010,4,3,0,0,0,1,8
MEGHALAYA,GARO HILLS WEST,2010,15,20,0,18,0,5,58
MEGHALAYA,JAINTIA HILLS,2010,33,3,0,1,0,0,37
MEGHALAYA,KHASI HILLS EAST,2010,41,2,0,10,0,17,70
MEGHALAYA,KHASI HILLS WEST,2010,28,4,0,10,0,0,42
MEGHALAYA,RI-BHOI,2010,23,2,0,6,0,1,32
MEGHALAYA,TOTAL,2010,149,37,0,48,0,24,258
MIZORAM,AIZAWL,2010,34,0,0,42,0,2,78
MIZORAM,CHAMPHAI,2010,20,0,0,5,0,0,25
MIZORAM,KOLASIB,2010,8,0,0,3,0,0,11
MIZORAM,LAWNGTLAI,2010,6,0,0,2,0,0,8
MIZORAM,LUNGLEI,2010,9,0,0,10,0,0,19
MIZORAM,MAMIT,2010,6,0,0,6,0,0,12
MIZORAM,SAIHA,2010,3,0,0,1,0,0,4
MIZORAM,SERCHHIP,2010,6,0,0,6,0,1,13
MIZORAM,TOTAL,2010,92,0,0,75,0,3,170
NAGALAND,DIMAPUR,2010,4,5,0,8,2,1,20
NAGALAND,KIPHIRE,2010,0,0,0,0,0,0,0
NAGALAND,KOHIMA,2010,3,0,0,1,0,0,4
NAGALAND,LONGLENG,2010,0,0,0,0,0,0,0
NAGALAND,MOKOKCHUNG,2010,2,0,0,1,0,0,3
NAGALAND,MON,2010,0,0,0,0,0,0,0
NAGALAND,PEREN,2010,0,0,0,0,1,0,1
NAGALAND,PHEK,2010,1,0,0,1,0,0,2
NAGALAND,TUENSANG,2010,1,0,0,2,0,0,3
NAGALAND,WOKHA,2010,2,1,0,0,0,0,3
NAGALAND,ZUNHEBOTO,2010,3,0,0,0,0,0,3
NAGALAND,TOTAL,2010,16,6,0,13,3,1,39
ODISHA,ANGUL,2010,39,42,13,253,5,68,420
ODISHA,BALASORE,2010,48,68,40,188,29,211,584
ODISHA,BARAGARH,2010,36,23,9,69,23,171,331
ODISHA,BERHAMPUR,2010,11,9,4,125,11,12,172
ODISHA,BHADRAK,2010,33,50,18,99,12,151,363
ODISHA,BOLANGIR,2010,48,16,4,188,9,112,377
ODISHA,BOUDH,2010,7,7,2,35,2,21,74
ODISHA,CUTTACK,2010,26,25,22,26,1,107,207
ODISHA,DCP BBSR,2010,43,29,18,45,8,41,184
ODISHA,DCP CTC,2010,17,27,4,18,3,84,153
ODISHA,DEOGARH,2010,11,4,0,57,3,17,92
ODISHA,DHENKANAL,2010,19,34,7,252,8,25,345
ODISHA,GAJAPATI,2010,6,17,0,37,2,16,78
ODISHA,GANJAM,2010,48,42,25,296,19,0,430
ODISHA,JAGATSINGHPUR,2010,24,37,15,10,1,76,163
ODISHA,JAJPUR,2010,30,32,30,64,8,80,244
ODISHA,JHARSUGUDA,2010,10,3,4,47,6,27,97
ODISHA,KALAHANDI,2010,60,35,16,118,12,91,332
ODISHA,KANDHAMAL,2010,27,26,3,84,3,26,169
ODISHA,KENDRAPARA,2010,38,33,39,8,0,22,140
ODISHA,KEONJHAR,2010,45,32,18,107,8,85,295
ODISHA,KHURDA,2010,41,31,8,19,2,109,210
ODISHA,KORAPUT,2010,41,19,0,122,11,42,235
ODISHA,MALKANGIR,2010,14,8,0,22,5,13,62
ODISHA,MAYURBHANJ,2010,76,72,27,189,10,146,520
ODISHA,NAYAGARH,2010,20,20,16,12,2,14,84
ODISHA,NOWRANGPUR,2010,48,33,2,93,10,39,225
ODISHA,NUAPADA,2010,13,10,0,44,3,9,79
ODISHA,PURI,2010,22,40,26,16,0,86,190
ODISHA,RAYAGADA,2010,28,30,7,79,4,27,175
ODISHA,ROURKELA,2010,26,19,3,71,6,64,189
ODISHA,SAMBALPUR,2010,27,14,2,34,3,52,132
ODISHA,SONEPUR,2010,17,5,3,43,2,12,82
ODISHA,SRP(CUTTACK),2010,0,2,0,8,0,0,10
ODISHA,SRP(ROURKELA),2010,2,2,1,8,0,1,14
ODISHA,SUNDARGARH,2010,24,16,2,19,1,10,72
ODISHA,TOTAL,2010,1025,912,388,2905,232,2067,7529
PUNJAB,AMRITSAR RURAL,2010,16,25,2,13,1,53,110
PUNJAB,BARNALA,2010,12,2,1,7,0,15,37
PUNJAB,BATALA,2010,26,23,4,16,0,31,100
PUNJAB,BHATINDA,2010,29,30,3,36,1,31,130
PUNJAB,CP AMRITSAR,2010,24,43,10,10,4,87,178
PUNJAB,CP JALANDHAR,2010,22,40,5,27,4,82,180
PUNJAB,CP LUDHIANA,2010,55,108,9,29,11,119,331
PUNJAB,FARIDKOT,2010,10,5,3,2,0,32,52
PUNJAB,FATEHGARH SAHIB,2010,11,11,1,6,2,19,50
PUNJAB,FEROZPUR,2010,39,28,10,9,0,52,138
PUNJAB,G.R.P,2010,0,0,1,0,0,0,1
PUNJAB,GURDASPUR,2010,30,28,11,19,2,42,132
PUNJAB,HOSHIARPUR,2010,26,36,5,17,1,74,159
PUNJAB,JALANDHAR RURAL,2010,39,26,4,24,4,62,159
PUNJAB,KAPURTHALA,2010,12,22,2,14,0,31,81
PUNJAB,KHANNA,2010,7,10,4,5,0,43,69
PUNJAB,LUDHIANA RURAL,2010,11,6,0,4,2,36,59
PUNJAB,MANSA,2010,22,9,7,2,1,23,64
PUNJAB,MOGA,2010,18,13,3,10,0,22,66
PUNJAB,MUKTSAR,2010,12,10,3,5,1,23,54
PUNJAB,PATIALA,2010,26,31,9,35,1,139,241
PUNJAB,ROPAR,2010,14,14,2,14,2,20,66
PUNJAB,SANGRUR,2010,31,7,8,18,0,51,115
PUNJAB,SAS NGR,2010,17,23,3,18,0,42,103
PUNJAB,SBS NAGAR,2010,17,8,6,5,1,18,55
PUNJAB,TARN TARAN,2010,20,18,5,4,0,16,63
PUNJAB,TOTAL,2010,546,576,121,349,38,1163,2793
RAJASTHAN,AJMER,2010,47,86,12,81,0,615,841
RAJASTHAN,ALWAR,2010,105,138,42,122,0,588,995
RAJASTHAN,BANSWARA,2010,61,53,8,47,1,151,321
RAJASTHAN,BARAN,2010,48,72,9,129,2,267,527
RAJASTHAN,BARMER,2010,34,33,18,71,0,194,350
RAJASTHAN,BHARATPUR,2010,83,152,33,38,0,437,743
RAJASTHAN,BHILWARA,2010,48,130,3,74,1,593,849
RAJASTHAN,BIKANER,2010,41,34,18,58,0,354,505
RAJASTHAN,BUNDI,2010,31,80,3,113,0,285,512
RAJASTHAN,CHITTORGARH,2010,42,96,6,76,0,516,736
RAJASTHAN,CHURU,2010,49,17,22,10,0,301,399
RAJASTHAN,DAUSA,2010,24,69,18,18,0,162,291
RAJASTHAN,DHOLPUR,2010,22,53,28,18,0,186,307
RAJASTHAN,DUNGARPUR,2010,26,50,5,56,0,100,237
RAJASTHAN,G.R.P. AJMER,2010,0,0,3,1,0,0,4
RAJASTHAN,G.R.P. JODHPUR,2010,2,0,0,1,2,0,5
RAJASTHAN,GANGANAGAR,2010,72,94,18,74,2,659,919
RAJASTHAN,HANUMANGARH,2010,56,44,15,98,0,427,640
RAJASTHAN,JAIPUR EAST,2010,28,66,10,42,0,231,377
RAJASTHAN,JAIPUR NORTH,2010,25,67,13,40,0,234,379
RAJASTHAN,JAIPUR RURAL,2010,27,90,13,63,1,253,447
RAJASTHAN,JAIPUR SOUTH,2010,18,47,7,33,0,255,360
RAJASTHAN,JAISALMER,2010,3,7,5,25,0,29,69
RAJASTHAN,JALORE,2010,13,29,14,36,0,122,214
RAJASTHAN,JHALAWAR,2010,62,48,6,187,4,303,610
RAJASTHAN,JHUNJHUNU,2010,49,50,15,45,0,251,410
RAJASTHAN,JODHPUR CITY,2010,27,43,13,31,3,247,364
RAJASTHAN,JODHPUR RURAL,2010,17,39,11,29,0,132,228
RAJASTHAN,KARAULI,2010,42,72,12,24,0,157,307
RAJASTHAN,KOTA CITY,2010,33,74,2,50,0,369,528
RAJASTHAN,KOTA RURAL,2010,36,35,2,67,0,199,339
RAJASTHAN,NAGAUR,2010,60,57,22,86,0,348,573
RAJASTHAN,PALI,2010,53,98,9,75,0,442,677
RAJASTHAN,PRATAPGARH,2010,56,56,7,69,0,173,361
RAJASTHAN,RAJSAMAND,2010,14,25,4,41,0,233,317
RAJASTHAN,SAWAI MADHOPUR,2010,16,65,0,26,0,179,286
RAJASTHAN,SIKAR,2010,52,86,12,11,0,313,474
RAJASTHAN,SIROHI,2010,20,27,6,63,0,175,291
RAJASTHAN,TONK,2010,18,44,4,19,1,338,424
RAJASTHAN,UDAIPUR,2010,111,151,14,192,6,327,801
RAJASTHAN,TOTAL,2010,1571,2477,462,2339,23,11145,18017
SIKKIM,EAST,2010,5,4,0,1,0,0,10
SIKKIM,NORTH,2010,0,0,0,0,0,0,0
SIKKIM,SOUTH,2010,9,1,0,5,0,2,17
SIKKIM,WEST,2010,4,1,1,5,0,1,12
SIKKIM,TOTAL,2010,18,6,1,11,0,3,39
TAMIL NADU,ARIYALUR,2010,20,24,1,64,4,10,123
TAMIL NADU,CHENNAI,2010,47,30,16,45,23,125,286
TAMIL NADU,CHENNAI RLY.,2010,0,0,2,2,0,0,4
TAMIL NADU,CHENNAISUBURBAN,2010,29,16,18,61,87,57,268
TAMIL NADU,COIMBATORE RURAL,2010,13,53,1,39,0,40,146
TAMIL NADU,COIMBATORE URBAN,2010,15,10,1,35,1,45,107
TAMIL NADU,CUDDALORE,2010,27,39,8,8,8,38,128
TAMIL NADU,DHARMAPURI,2010,15,41,6,42,3,49,156
TAMIL NADU,DINDIGUL,2010,9,43,1,43,0,107,203
TAMIL NADU,ERODE,2010,15,39,2,43,2,26,127
TAMIL NADU,KANCHIPURAM,2010,17,9,1,23,2,13,65
TAMIL NADU,KANYAKUMARI,2010,12,55,2,10,102,93,274
TAMIL NADU,KARUR,2010,10,52,4,28,7,10,111
TAMIL NADU,KRISHNAGIRI,2010,20,53,5,27,0,42,147
TAMIL NADU,MADURAI RURAL,2010,17,41,14,62,6,77,217
TAMIL NADU,MADURAI URBAN,2010,3,9,11,12,20,69,124
TAMIL NADU,NAGAPATTINAM,2010,9,31,1,57,7,3,108
TAMIL NADU,NAMAKKAL,2010,10,42,2,52,10,12,128
TAMIL NADU,NILGIRIS,2010,7,6,0,10,12,2,37
TAMIL NADU,PERAMBALUR,2010,5,9,0,16,12,3,45
TAMIL NADU,PUDUKOTTAI,2010,7,48,5,42,2,14,118
TAMIL NADU,RAMNATHAPURAM,2010,16,50,1,14,4,17,102
TAMIL NADU,SALEM RURAL,2010,53,137,4,165,0,62,421
TAMIL NADU,SALEM URBAN,2010,21,38,3,25,23,46,156
TAMIL NADU,SIVAGANGAI,2010,1,30,4,16,1,35,87
TAMIL NADU,THANJAVUR,2010,7,42,3,75,0,9,136
TAMIL NADU,THENI,2010,18,80,5,61,65,125,354
TAMIL NADU,THIRUNELVELI RURAL,2010,48,58,3,88,0,52,249
TAMIL NADU,THIRUNELVELI URBAN,2010,16,9,0,5,0,4,34
TAMIL NADU,THIRUVALLUR,2010,18,13,6,10,1,19,67
TAMIL NADU,THIRUVANNAMALAI,2010,15,39,0,8,0,30,92
TAMIL NADU,THIRUVARUR,2010,12,18,0,20,0,13,63
TAMIL NADU,THOOTHUGUDI,2010,32,25,3,4,0,57,121
TAMIL NADU,TIRUPPUR,2010,10,44,6,24,0,46,130
TAMIL NADU,TRICHY RLY.,2010,0,0,1,0,0,0,1
TAMIL NADU,TRICHY RURAL,2010,8,24,5,26,0,36,99
TAMIL NADU,TRICHY URBAN,2010,4,15,6,10,92,33,160
TAMIL NADU,VELLORE,2010,30,56,8,28,1,65,188
TAMIL NADU,VILLUPURAM,2010,50,78,4,80,43,26,281
TAMIL NADU,VIRUDHUNAGAR,2010,20,58,2,25,100,60,265
TAMIL NADU,TOTAL,2010,686,1464,165,1405,638,1570,5928
TRIPURA,DHALAI,2010,33,6,3,26,1,65,134
TRIPURA,G.R.P.,2010,0,0,0,1,0,0,1
TRIPURA,NORTH,2010,51,22,2,70,0,186,331
TRIPURA,SOUTH,2010,36,21,10,165,3,255,490
TRIPURA,WEST,2010,118,42,10,114,5,431,720
TRIPURA,TOTAL,2010,238,91,25,376,9,937,1676
UTTAR PRADESH,AGRA,2010,26,212,80,91,0,355,764
UTTAR PRADESH,ALIGARH,2010,63,237,69,164,0,318,851
UTTAR PRADESH,ALLAHABAD,2010,33,116,84,55,0,177,465
UTTAR PRADESH,AMBEDKAR NAGAR,2010,20,56,18,14,0,98,206
UTTAR PRADESH,AURAIYA,2010,11,40,17,19,0,36,123
UTTAR PRADESH,AZAMGARH,2010,23,65,23,17,0,70,198
UTTAR PRADESH,BADAUN,2010,22,69,48,49,0,41,229
UTTAR PRADESH,BAGHPAT,2010,14,41,14,13,0,87,169
UTTAR PRADESH,BAHRAICH,2010,25,127,42,40,1,83,318
UTTAR PRADESH,BALLIA,2010,4,28,30,14,0,24,100
UTTAR PRADESH,BALRAMPUR,2010,11,27,5,7,0,16,66
UTTAR PRADESH,BANDA,2010,22,34,20,39,0,37,152
UTTAR PRADESH,BARABANKI,2010,22,90,20,34,0,97,263
UTTAR PRADESH,BAREILLY,2010,44,163,55,97,0,214,573
UTTAR PRADESH,BASTI,2010,8,30,14,7,0,17,76
UTTAR PRADESH,BIJNOR,2010,40,100,27,56,0,254,477
UTTAR PRADESH,BULANDSHAHAR,2010,24,127,40,60,0,327,578
UTTAR PRADESH,CHANDOLI,2010,3,12,15,6,0,67,103
UTTAR PRADESH,CHITRAKOOT DHAM,2010,15,13,15,23,0,16,82
UTTAR PRADESH,CSM NAGAR,2010,30,75,13,17,0,9,144
UTTAR PRADESH,DEORIA,2010,4,18,21,4,0,9,56
UTTAR PRADESH,ETAH,2010,11,60,30,45,0,72,218
UTTAR PRADESH,ETAWAH,2010,4,44,29,19,0,81,177
UTTAR PRADESH,FAIZABAD,2010,16,69,18,27,0,16,146
UTTAR PRADESH,FATEHGARH,2010,11,55,24,26,0,30,146
UTTAR PRADESH,FATEHPUR,2010,33,57,42,53,2,83,270
UTTAR PRADESH,FIROZABAD,2010,18,78,54,33,0,83,266
UTTAR PRADESH,G.R.P.,2010,1,6,3,20,0,0,30
UTTAR PRADESH,GAUTAMBUDH NAGAR,2010,39,77,19,41,0,132,308
UTTAR PRADESH,GHAZIABAD,2010,44,285,69,77,0,536,1011
UTTAR PRADESH,GHAZIPUR,2010,5,15,32,12,0,41,105
UTTAR PRADESH,GONDA,2010,9,67,47,30,0,6,159
UTTAR PRADESH,GORAKHPUR,2010,45,199,61,69,0,266,640
UTTAR PRADESH,HAMIRPUR,2010,6,13,15,25,0,22,81
UTTAR PRADESH,HARDOI,2010,20,73,24,50,0,55,222
UTTAR PRADESH,HATHRAS,2010,24,60,30,45,0,107,266
UTTAR PRADESH,J.P.NAGAR,2010,24,52,21,25,0,69,191
UTTAR PRADESH,JALAUN,2010,5,28,23,28,0,32,116
UTTAR PRADESH,JAUNPUR,2010,12,60,39,32,0,57,200
UTTAR PRADESH,JHANSI,2010,9,32,32,43,1,7,124
UTTAR PRADESH,KANNAUJ,2010,7,43,22,23,0,39,134
UTTAR PRADESH,KANPUR NAGAR,2010,42,263,92,118,7,447,969
UTTAR PRADESH,KANSHIRAM NAGAR,2010,10,35,26,23,0,28,122
UTTAR PRADESH,KAUSHAMBI,2010,12,29,22,33,0,59,155
UTTAR PRADESH,KHIRI,2010,26,80,37,37,0,33,213
UTTAR PRADESH,KUSHI NAGAR,2010,11,25,25,13,0,12,86
UTTAR PRADESH,LALITPUR,2010,7,9,8,17,0,17,58
UTTAR PRADESH,LUCKNOW,2010,75,320,66,155,0,745,1361
UTTAR PRADESH,MAHARAJGANJ,2010,16,45,14,11,0,50,136
UTTAR PRADESH,MAHOBA,2010,9,15,14,28,0,18,84
UTTAR PRADESH,MAINPURI,2010,15,66,28,37,0,16,162
UTTAR PRADESH,MATHURA,2010,24,79,29,49,0,219,400
UTTAR PRADESH,MAU,2010,10,41,17,30,0,49,147
UTTAR PRADESH,MEERUT,2010,64,147,43,91,0,344,689
UTTAR PRADESH,MIRZAPUR,2010,2,3,25,4,0,137,171
UTTAR PRADESH,MORADABAD,2010,66,184,41,76,0,268,635
UTTAR PRADESH,MUZAFFARNAGAR,2010,34,174,40,52,0,341,641
UTTAR PRADESH,PILIBHIT,2010,16,54,30,25,0,113,238
UTTAR PRADESH,PRATAPGARH,2010,23,64,34,25,0,74,220
UTTAR PRADESH,RAIBAREILLY,2010,27,47,20,39,0,63,196
UTTAR PRADESH,RAMABAI NAGAR,2010,12,80,22,38,0,88,240
UTTAR PRADESH,RAMPUR,2010,65,96,23,44,0,121,349
UTTAR PRADESH,SAHARANPUR,2010,11,35,26,20,0,140,232
UTTAR PRADESH,SANT KABIRNAGAR,2010,24,44,6,17,0,25,116
UTTAR PRADESH,SHAHJAHANPUR,2010,45,85,50,44,0,12,236
UTTAR PRADESH,SHRAWASTI,2010,14,23,16,19,0,3,75
UTTAR PRADESH,SIDHARTHNAGAR,2010,8,38,15,17,0,33,111
UTTAR PRADESH,SITAPUR,2010,11,109,45,54,0,111,330
UTTAR PRADESH,SONBHADRA,2010,21,20,20,13,0,16,90
UTTAR PRADESH,ST.RAVIDASNAGAR,2010,1,9,11,3,0,8,32
UTTAR PRADESH,SULTANPUR,2010,14,49,16,41,0,62,182
UTTAR PRADESH,UNNAO,2010,32,76,26,57,0,74,265
UTTAR PRADESH,VARANASI,2010,9,71,26,14,0,166,286
UTTAR PRADESH,TOTAL,2010,1563,5468,2217,2793,11,7978,20030
UTTARAKHAND,ALMORA,2010,3,5,4,3,0,4,19
UTTARAKHAND,BAGESHWAR,2010,2,2,2,3,1,1,11
UTTARAKHAND,CHAMOLI,2010,1,0,0,3,0,1,5
UTTARAKHAND,CHAMPAWAT,2010,1,0,1,1,0,0,3
UTTARAKHAND,DEHRADUN,2010,37,57,12,26,74,117,323
UTTARAKHAND,HARIDWAR,2010,28,71,15,31,67,103,315
UTTARAKHAND,NAINITAL,2010,13,29,5,15,17,15,94
UTTARAKHAND,PAURI GARHWAL,2010,4,3,4,5,3,7,26
UTTARAKHAND,PITHORAGARH,2010,3,5,1,5,0,6,20
UTTARAKHAND,RUDRA PRAYAG,2010,5,3,6,3,1,1,19
UTTARAKHAND,TEHRI GARHWAL,2010,1,2,2,6,0,1,12
UTTARAKHAND,UDHAMSINGH NAGAR,2010,22,69,23,23,0,75,212
UTTARAKHAND,UTTARKASHI,2010,1,3,0,1,2,3,10
UTTARAKHAND,TOTAL,2010,121,249,75,125,165,334,1069
WEST BENGAL,24 PARGANAS NORTH,2010,173,292,71,174,8,2378,3096
WEST BENGAL,24 PARGANAS SOUTH,2010,258,215,48,113,0,2879,3513
WEST BENGAL,ASANSOL,2010,18,13,19,13,0,310,373
WEST BENGAL,BANKURA,2010,36,45,18,59,2,279,439
WEST BENGAL,BIRBHUM,2010,44,29,25,48,0,301,447
WEST BENGAL,BURDWAN,2010,72,69,28,93,0,693,955
WEST BENGAL,COOCHBEHAR,2010,143,170,12,62,0,535,922
WEST BENGAL,DAKSHIN DINAJPUR,2010,56,87,19,77,0,264,503
WEST BENGAL,DARJEELING,2010,36,75,2,57,7,158,335
WEST BENGAL,HOOGHLY,2010,52,87,12,47,0,694,892
WEST BENGAL,HOWRAH,2010,59,154,31,121,0,1078,1443
WEST BENGAL,HOWRAH G.R.P.,2010,0,4,0,8,0,0,12
WEST BENGAL,JALPAIGURI,2010,180,206,12,269,0,649,1316
WEST BENGAL,KHARAGPUR G.R.P.,2010,0,1,0,0,0,0,1
WEST BENGAL,KOLKATA,2010,32,91,12,226,133,400,894
WEST BENGAL,MALDA,2010,167,122,6,139,1,621,1056
WEST BENGAL,MURSHIDABAD,2010,526,441,45,609,6,2927,4554
WEST BENGAL,NADIA,2010,167,339,65,102,4,1586,2263
WEST BENGAL,PASCHIM MIDNAPUR,2010,67,101,18,70,1,669,926
WEST BENGAL,PURAB MIDNAPUR,2010,51,120,27,16,0,702,916
WEST BENGAL,PURULIA,2010,42,0,13,60,0,194,309
WEST BENGAL,SEALDAH G.R.P.,2010,2,3,2,5,0,2,14
WEST BENGAL,SILIGURI G.R.P.,2010,0,1,0,3,0,0,4
WEST BENGAL,UTTAR DINAJPUR,2010,130,99,22,94,1,477,823
WEST BENGAL,TOTAL,2010,2311,2764,507,2465,163,17796,26006
A & N ISLANDS,ANDAMAN,2010,23,8,0,31,10,9,81
A & N ISLANDS,NICOBAR,2010,1,0,0,0,0,0,1
A & N ISLANDS,TOTAL,2010,24,8,0,31,10,9,82
CHANDIGARH,CHANDIGARH,2010,31,28,5,29,4,41,138
CHANDIGARH,TOTAL,2010,31,28,5,29,4,41,138
D & N HAVELI,D and N HAVELI,2010,3,10,0,11,2,3,29
D & N HAVELI,TOTAL,2010,3,10,0,11,2,3,29
DAMAN & DIU,DAMAN,2010,1,2,0,2,0,1,6
DAMAN & DIU,DIU,2010,0,0,0,0,0,2,2
DAMAN & DIU,TOTAL,2010,1,2,0,2,0,3,8
DELHI,CAW,2010,0,0,0,0,0,187,187
DELHI,CENTRAL,2010,20,62,2,25,3,62,174
DELHI,CRIME BRANCH,2010,0,0,0,0,0,0,0
DELHI,DELHI UT TOTAL,2010,507,1740,143,601,80,1404,4475
DELHI,EAST,2010,47,192,12,83,8,163,505
DELHI,EOW,2010,0,0,0,0,0,0,0
DELHI,GRP(RLY),2010,2,5,0,3,0,0,10
DELHI,IGI AIRPORT,2010,0,0,0,7,0,0,7
DELHI,NEW DELHI,2010,16,21,0,20,10,2,69
DELHI,NORTH,2010,7,88,8,23,8,63,197
DELHI,NORTH-EAST,2010,51,252,24,68,5,216,616
DELHI,NORTH-WEST,2010,50,132,11,62,5,163,423
DELHI,OUTER,2010,49,260,21,64,9,124,527
DELHI,SOUTH,2010,59,144,9,66,10,79,367
DELHI,SOUTH-EAST,2010,80,189,13,92,10,60,444
DELHI,SOUTH-WEST,2010,54,203,24,28,5,94,408
DELHI,STF,2010,0,0,0,0,0,0,0
DELHI,WEST,2010,72,192,19,60,7,191,541
LAKSHADWEEP,LAKSHADWEEP,2010,0,0,0,0,0,0,0
LAKSHADWEEP,TOTAL,2010,0,0,0,0,0,0,0
PUDUCHERRY,KARAIKAL,2010,1,2,0,15,5,1,24
PUDUCHERRY,PUDUCHERRY,2010,2,12,1,31,17,6,69
PUDUCHERRY,TOTAL,2010,3,14,1,46,22,7,93
ANDHRA PRADESH,ADILABAD,2011,84,70,20,112,142,429,857
ANDHRA PRADESH,ANANTAPUR,2011,16,83,36,156,16,198,505
ANDHRA PRADESH,CHITTOOR,2011,17,47,25,124,168,421,802
ANDHRA PRADESH,CUDDAPAH,2011,41,65,15,144,17,122,404
ANDHRA PRADESH,CYBERABAD,2011,89,90,51,158,234,1411,2033
ANDHRA PRADESH,EAST GODAVARI,2011,72,51,17,176,224,575,1115
ANDHRA PRADESH,GUNTAKAL RLY.,2011,0,0,0,0,3,1,4
ANDHRA PRADESH,GUNTUR,2011,40,57,8,223,140,494,962
ANDHRA PRADESH,GUNTUR URBAN,2011,33,28,6,86,111,395,659
ANDHRA PRADESH,HYDERABAD CITY,2011,59,39,37,157,93,1355,1740
ANDHRA PRADESH,KARIMNAGAR,2011,58,120,40,253,235,702,1408
ANDHRA PRADESH,KHAMMAM,2011,84,73,20,243,140,519,1079
ANDHRA PRADESH,KRISHNA,2011,80,75,15,348,292,733,1543
ANDHRA PRADESH,KURNOOL,2011,39,58,20,340,222,424,1103
ANDHRA PRADESH,MAHABOOBNAGAR,2011,88,69,28,162,66,259,672
ANDHRA PRADESH,MEDAK,2011,38,33,26,121,50,384,652
ANDHRA PRADESH,NALGONDA,2011,48,51,36,229,150,255,769
ANDHRA PRADESH,NELLORE,2011,28,81,7,166,119,187,588
ANDHRA PRADESH,NIZAMABAD,2011,63,51,27,98,100,569,908
ANDHRA PRADESH,PRAKASHAM,2011,24,81,11,243,56,266,681
ANDHRA PRADESH,RAJAHMUNDRY,2011,15,28,3,44,34,189,313
ANDHRA PRADESH,RANGA REDDY,2011,24,20,15,50,2,89,200
ANDHRA PRADESH,SECUNDERABAD RLY.,2011,0,1,1,5,1,2,10
ANDHRA PRADESH,SRIKAKULAM,2011,29,23,8,91,83,333,567
ANDHRA PRADESH,TIRUPATHI URBAN,2011,10,1,5,40,7,112,175
ANDHRA PRADESH,VIJAYAWADA CITY,2011,37,50,17,248,355,1066,1773
ANDHRA PRADESH,VIJAYAWADA RLY.,2011,1,2,1,3,2,1,10
ANDHRA PRADESH,VISAKHA RURAL,2011,38,30,8,120,128,203,527
ANDHRA PRADESH,VISAKHAPATNAM,2011,57,48,12,31,50,386,584
ANDHRA PRADESH,VIZIANAGARAM,2011,50,20,5,79,99,384,637
ANDHRA PRADESH,WARANGAL,2011,48,62,26,157,27,89,409
ANDHRA PRADESH,WARANGAL URBAN,2011,35,15,26,78,54,63,271
ANDHRA PRADESH,WEST GODAVARI,2011,97,90,27,364,238,760,1576
ANDHRA PRADESH,TOTAL,2011,1442,1612,599,4849,3658,13376,25536
ARUNACHAL PRADESH,ANJAW,2011,0,0,0,0,0,0,0
ARUNACHAL PRADESH,CHANGLANG,2011,3,7,0,3,0,2,15
ARUNACHAL PRADESH,DIBANG VALLEY,2011,3,2,0,1,0,0,6
ARUNACHAL PRADESH,K/KUMEY,2011,4,0,0,0,0,0,4
ARUNACHAL PRADESH,KAMENG EAST,2011,3,2,0,3,0,0,8
ARUNACHAL PRADESH,KAMENG WEST,2011,0,1,0,4,0,0,5
ARUNACHAL PRADESH,LOHIT,2011,5,4,0,2,0,0,11
ARUNACHAL PRADESH,PAPUM PARE,2011,4,17,0,7,0,9,37
ARUNACHAL PRADESH,RURAL,2011,2,4,0,4,0,3,13
ARUNACHAL PRADESH,SIANG EAST,2011,8,4,0,7,0,2,21
ARUNACHAL PRADESH,SIANG UPPER,2011,1,3,0,3,0,0,7
ARUNACHAL PRADESH,SIANG WEST,2011,2,5,0,8,0,2,17
ARUNACHAL PRADESH,SUBANSIRI LOWER,2011,2,3,0,0,0,0,5
ARUNACHAL PRADESH,SUBANSIRI UPPER,2011,2,6,0,5,0,0,13
ARUNACHAL PRADESH,TAWANG,2011,0,1,0,1,0,0,2
ARUNACHAL PRADESH,TIRAP,2011,3,1,0,3,0,0,7
ARUNACHAL PRADESH,UPPER DIBANG VALLEY,2011,0,0,0,0,0,0,0
ARUNACHAL PRADESH,TOTAL,2011,42,60,0,51,0,18,171
ASSAM,BARPETA,2011,92,156,5,25,0,336,614
ASSAM,BASKA,2011,29,60,3,4,0,25,121
ASSAM,BONGAIGAON,2011,72,64,5,2,0,126,269
ASSAM,C.I.D.,2011,0,0,0,0,0,0,0
ASSAM,CACHAR,2011,74,167,4,7,0,498,750
ASSAM,CHIRANG,2011,30,40,4,8,0,51,133
ASSAM,DARRANG,2011,95,192,2,109,2,164,564
ASSAM,DHEMAJI,2011,62,59,5,40,0,122,288
ASSAM,DHUBRI,2011,157,276,12,210,2,693,1350
ASSAM,DIBRUGARH,2011,54,29,0,7,0,135,225
ASSAM,G.R.P.,2011,1,1,0,0,0,0,2
ASSAM,GOALPARA,2011,99,89,3,2,0,142,335
ASSAM,GOLAGHAT,2011,54,146,1,66,0,194,461
ASSAM,GUWAHATI CITY,2011,56,306,10,112,0,213,697
ASSAM,HAILAKANDI,2011,61,63,4,27,0,126,281
ASSAM,JORHAT,2011,49,11,2,49,0,172,283
ASSAM,KAMRUP,2011,63,139,6,61,0,147,416
ASSAM,KARBI ANGLONG,2011,13,35,0,22,0,20,90
ASSAM,KARIMGANJ,2011,46,68,4,15,0,194,327
ASSAM,KOKRAJHAR,2011,52,79,1,31,0,120,283
ASSAM,LAKHIMPUR,2011,52,120,0,57,0,119,348
ASSAM,MORIGAON,2011,54,93,3,12,0,112,274
ASSAM,N.C.HILLS,2011,3,8,1,0,0,4,16
ASSAM,NAGAON,2011,165,358,20,82,4,772,1401
ASSAM,NALBARI,2011,28,83,4,95,0,140,350
ASSAM,R.P.O.,2011,5,3,0,1,0,10,19
ASSAM,SIBSAGAR,2011,49,118,8,78,0,99,352
ASSAM,SONITPUR,2011,96,231,12,34,0,346,719
ASSAM,TINSUKIA,2011,61,135,1,27,0,121,345
ASSAM,UDALGURI,2011,28,63,1,10,0,45,147
ASSAM,TOTAL,2011,1700,3192,121,1193,8,5246,11460
BIHAR,ARARIA,2011,69,91,26,14,0,24,224
BIHAR,ARWAL,2011,5,9,24,8,0,8,54
BIHAR,AURANGABAD,2011,18,60,30,32,0,152,292
BIHAR,BAGAHA,2011,16,48,13,8,0,15,100
BIHAR,BANKA,2011,26,56,31,8,0,26,147
BIHAR,BEGUSARAI,2011,17,94,39,12,0,39,201
BIHAR,BETTIAH,2011,21,81,32,7,0,67,208
BIHAR,BHABHUA,2011,9,36,33,32,0,17,127
BIHAR,BHAGALPUR,2011,23,94,12,10,0,17,156
BIHAR,BHOJPUR,2011,16,48,40,2,0,72,178
BIHAR,BUXAR,2011,13,52,37,6,0,59,167
BIHAR,DARBHANGA,2011,34,97,38,202,0,284,655
BIHAR,GAYA,2011,23,63,56,7,0,47,196
BIHAR,GOPALGANJ,2011,17,106,35,30,0,56,244
BIHAR,JAMALPUR RLY.,2011,0,0,0,2,0,1,3
BIHAR,JAMUI,2011,23,28,13,34,0,40,138
BIHAR,JEHANABAD,2011,10,14,20,8,0,22,74
BIHAR,KATIHAR,2011,103,102,29,10,0,25,269
BIHAR,KATIHAR RLY.,2011,2,0,0,4,0,2,8
BIHAR,KHAGARIA,2011,14,42,15,0,0,26,97
BIHAR,KISHANGANJ,2011,30,60,13,20,0,50,173
BIHAR,LAKHISARAI,2011,5,31,14,12,0,44,106
BIHAR,MADHEPURA,2011,8,67,11,0,0,21,107
BIHAR,MADHUBANI,2011,44,148,35,0,0,138,365
BIHAR,MOTIHARI,2011,37,179,69,8,0,57,350
BIHAR,MUNGER,2011,7,56,10,2,0,49,124
BIHAR,MUZAFFARPUR,2011,56,219,76,4,0,91,446
BIHAR,MUZAFFARPUR RLY.,2011,0,4,1,11,0,0,16
BIHAR,NALANDA,2011,15,72,55,29,0,96,267
BIHAR,NAUGACHIA,2011,7,20,8,6,0,44,85
BIHAR,NAWADAH,2011,12,33,21,35,0,57,158
BIHAR,PATNA,2011,41,167,112,1,2,317,640
BIHAR,PATNA RLY.,2011,1,0,2,11,0,0,14
BIHAR,PURNEA,2011,62,78,13,24,3,140,320
BIHAR,ROHTAS,2011,20,84,32,46,0,57,239
BIHAR,SAHARSA,2011,8,41,17,35,0,27,128
BIHAR,SAMASTIPUR,2011,40,105,46,9,2,66,268
BIHAR,SARAN,2011,10,137,74,46,0,131,398
BIHAR,SHEIKHPURA,2011,3,14,8,0,0,35,60
BIHAR,SHEOHAR,2011,4,20,5,3,1,15,48
BIHAR,SITAMARHI,2011,8,49,29,14,0,33,133
BIHAR,SIWAN,2011,16,150,139,4,3,53,365
BIHAR,SUPAUL,2011,23,48,24,8,0,28,131
BIHAR,VAISHALI,2011,18,147,76,26,0,59,326
BIHAR,TOTAL,2011,934,3050,1413,790,11,2607,8805
CHHATTISGARH,BALRAMPUR,2011,55,0,3,52,0,23,133
CHHATTISGARH,BILASPUR,2011,70,16,17,146,4,72,325
CHHATTISGARH,BIZAPUR,2011,4,2,0,5,0,3,14
CHHATTISGARH,DANTEWARA,2011,8,7,0,10,1,9,35
CHHATTISGARH,DHAMTARI,2011,27,18,4,44,3,16,112
CHHATTISGARH,DURG,2011,115,86,13,291,43,131,679
CHHATTISGARH,GARIYABAND,2011,21,1,5,30,1,8,66
CHHATTISGARH,GRP RAIPUR,2011,2,0,1,1,0,1,5
CHHATTISGARH,JAGDALPUR,2011,68,9,0,29,3,19,128
CHHATTISGARH,JANJGIR,2011,33,10,15,114,15,104,291
CHHATTISGARH,JASHPUR,2011,78,33,1,69,2,36,219
CHHATTISGARH,KABIRDHAM,2011,23,16,2,43,7,14,105
CHHATTISGARH,KANKER,2011,29,4,4,14,2,10,63
CHHATTISGARH,KORBA,2011,39,2,5,86,12,48,192
CHHATTISGARH,KORIYA,2011,72,11,3,95,1,55,237
CHHATTISGARH,MAHASAMUND,2011,30,35,2,65,11,31,174
CHHATTISGARH,NARAYANPUR,2011,5,0,0,2,1,0,8
CHHATTISGARH,RAIGARH,2011,62,10,11,84,6,32,205
CHHATTISGARH,RAIPUR,2011,133,35,11,232,53,100,564
CHHATTISGARH,RAJNANDGAON,2011,38,21,4,70,3,23,159
CHHATTISGARH,SARGUJA,2011,65,32,0,114,3,36,250
CHHATTISGARH,SURAJPUR,2011,76,17,3,58,3,63,220
CHHATTISGARH,TOTAL,2011,1053,365,104,1654,174,834,4184
GOA,NORTH GOA,2011,13,8,1,20,9,10,61
GOA,SOUTH GOA,2011,16,9,0,9,3,8,45
GOA,TOTAL,2011,29,17,1,29,12,18,106
GUJARAT,AHMEDABAD COMMR.,2011,60,184,19,83,16,1390,1752
GUJARAT,AHMEDABAD RURAL,2011,10,71,1,22,0,131,235
GUJARAT,AHWA-DANG,2011,1,0,1,1,0,8,11
GUJARAT,AMRELI,2011,10,77,0,28,1,143,259
GUJARAT,ANAND,2011,10,42,0,20,0,196,268
GUJARAT,BHARUCH,2011,13,27,0,9,0,4,53
GUJARAT,BHAVNAGAR,2011,8,88,0,35,33,181,345
GUJARAT,CID CRIME,2011,0,0,0,0,0,0,0
GUJARAT,DAHOD,2011,6,48,0,11,0,14,79
GUJARAT,GANDHINAGAR,2011,14,16,0,16,1,132,179
GUJARAT,HIMATNAGAR,2011,10,46,0,29,4,229,318
GUJARAT,JAMNAGAR,2011,21,51,0,34,8,356,470
GUJARAT,JUNAGADH,2011,11,68,1,26,4,423,533
GUJARAT,KHEDA NORTH,2011,12,48,0,14,0,132,206
GUJARAT,KUTCH (EAST(G)),2011,8,17,2,13,1,137,178
GUJARAT,KUTCH (WEST-BHUJ),2011,15,15,0,14,0,108,152
GUJARAT,MEHSANA,2011,9,63,2,20,2,242,338
GUJARAT,NARMADA,2011,7,4,0,3,0,5,19
GUJARAT,NAVSARI,2011,2,10,0,6,2,31,51
GUJARAT,PALANPUR,2011,38,87,1,64,1,349,540
GUJARAT,PANCHMAHAL,2011,10,57,0,33,0,249,349
GUJARAT,PATAN,2011,16,44,0,43,1,156,260
GUJARAT,PORBANDAR,2011,6,9,0,1,1,84,101
GUJARAT,RAJKOT COMMR.,2011,10,34,0,17,3,246,310
GUJARAT,RAJKOT RURAL,2011,23,69,2,21,6,279,400
GUJARAT,SURAT COMMR.,2011,36,83,0,34,3,276,432
GUJARAT,SURAT RURAL,2011,6,14,0,9,0,55,84
GUJARAT,SURENDRANAGAR,2011,19,41,0,28,4,129,221
GUJARAT,TAPI,2011,2,2,0,3,0,9,16
GUJARAT,VADODARA COMMR.,2011,9,44,1,15,2,240,311
GUJARAT,VADODARA RURAL,2011,28,62,0,19,0,95,204
GUJARAT,VALSAD,2011,9,19,0,6,0,23,57
GUJARAT,W.RLY AHMEDABAD,2011,0,1,0,6,0,0,7
GUJARAT,W.RLY VADODARA,2011,0,1,0,2,0,0,3
GUJARAT,TOTAL,2011,439,1442,30,685,93,6052,8741
HARYANA,AMBALA,2011,37,23,5,28,20,191,304
HARYANA,BHIWANI,2011,41,30,18,26,12,97,224
HARYANA,FARIDABAD,2011,54,82,10,31,59,218,454
HARYANA,FATEHABAD,2011,15,18,7,6,8,86,140
HARYANA,GRP,2011,0,2,4,2,130,0,138
HARYANA,GURGAON,2011,40,37,25,27,29,107,265
HARYANA,HISSAR,2011,36,62,14,37,18,248,415
HARYANA,JHAJJAR,2011,32,19,12,20,26,117,226
HARYANA,JIND,2011,37,28,15,15,13,91,199
HARYANA,KAITHAL,2011,20,17,8,18,0,119,182
HARYANA,KARNAL,2011,62,18,18,25,26,166,315
HARYANA,KURUKSHETRA,2011,29,30,7,22,20,68,176
HARYANA,MAHENDRAGARH,2011,26,38,11,22,0,85,182
HARYANA,MEWAT,2011,28,23,7,9,3,119,189
HARYANA,PALWAL,2011,54,43,13,32,0,75,217
HARYANA,PANCHKULA,2011,17,15,2,9,0,77,120
HARYANA,PANIPAT,2011,47,70,11,29,19,163,339
HARYANA,REWARI,2011,17,19,7,19,34,94,190
HARYANA,ROHTAK,2011,57,32,9,38,52,124,312
HARYANA,SIRSA,2011,21,49,16,26,0,170,282
HARYANA,SONIPAT,2011,27,42,23,19,15,156,282
HARYANA,YAMUNANAGAR,2011,36,36,13,14,6,169,274
HARYANA,TOTAL,2011,733,733,255,474,490,2740,5425
HIMACHAL PRADESH,BADDIPOLICEDIST,2011,8,15,0,7,0,9,39
HIMACHAL PRADESH,BILASPUR,2011,8,3,0,18,9,17,55
HIMACHAL PRADESH,CHAMBA,2011,6,18,2,29,3,10,68
HIMACHAL PRADESH,CID,2011,0,0,0,0,0,0,0
HIMACHAL PRADESH,G.R.P.,2011,0,0,0,0,0,0,0
HIMACHAL PRADESH,HAMIRPUR,2011,5,7,0,17,12,5,46
HIMACHAL PRADESH,KANGRA,2011,32,55,1,60,12,42,202
HIMACHAL PRADESH,KINNAUR,2011,6,1,1,4,0,1,13
HIMACHAL PRADESH,KULLU,2011,20,12,0,38,2,21,93
HIMACHAL PRADESH,LAHAUL-SPITI,2011,1,0,0,0,0,0,1
HIMACHAL PRADESH,MANDI,2011,26,16,0,55,12,40,149
HIMACHAL PRADESH,SHIMLA,2011,22,24,0,45,5,16,112
HIMACHAL PRADESH,SIRMAUR,2011,12,17,0,33,1,23,86
HIMACHAL PRADESH,SOLAN,2011,11,13,0,8,0,16,48
HIMACHAL PRADESH,UNA,2011,11,10,0,17,6,39,83
HIMACHAL PRADESH,TOTAL,2011,168,191,4,331,62,239,995
JAMMU & KASHMIR,ANANTNAG,2011,18,108,0,134,46,6,312
JAMMU & KASHMIR,AWANTIPORA,2011,4,26,0,13,5,3,51
JAMMU & KASHMIR,BANDIPORA,2011,1,57,0,61,5,3,127
JAMMU & KASHMIR,BARAMULLA,2011,12,73,0,94,23,1,203
JAMMU & KASHMIR,BUDGAM,2011,8,100,0,94,27,2,231
JAMMU & KASHMIR,CRIME JAMMU,2011,0,0,0,0,0,0,0
JAMMU & KASHMIR,CRIME SRINAGAR,2011,0,0,0,0,0,0,0
JAMMU & KASHMIR,DODA,2011,16,43,0,25,7,20,111
JAMMU & KASHMIR,GANDERBAL,2011,9,30,0,57,1,1,98
JAMMU & KASHMIR,HANDWARA,2011,6,33,0,76,14,1,130
JAMMU & KASHMIR,JAMMU,2011,35,61,3,38,45,51,233
JAMMU & KASHMIR,KARGIL,2011,1,1,0,2,0,2,6
JAMMU & KASHMIR,KATHUA,2011,17,32,5,32,8,19,113
JAMMU & KASHMIR,KISHTWAR,2011,4,25,0,12,1,16,58
JAMMU & KASHMIR,KULGAM,2011,10,44,0,68,12,1,135
JAMMU & KASHMIR,KUPWARA,2011,11,45,0,45,11,4,116
JAMMU & KASHMIR,LEH,2011,3,0,0,7,1,0,11
JAMMU & KASHMIR,POONCH,2011,18,32,0,31,7,29,117
JAMMU & KASHMIR,PULWAMA,2011,5,34,0,11,7,0,57
JAMMU & KASHMIR,RAILWAYS JAMMU,2011,0,0,0,0,0,0,0
JAMMU & KASHMIR,RAILWAYS KASHMIR,2011,0,0,0,0,1,0,1
JAMMU & KASHMIR,RAJOURI,2011,32,43,1,30,4,49,159
JAMMU & KASHMIR,RAMBAN,2011,13,15,0,12,4,0,44
JAMMU & KASHMIR,REASI,2011,11,15,0,11,5,1,43
JAMMU & KASHMIR,SAMBA,2011,3,11,2,6,17,5,44
JAMMU & KASHMIR,SHOPIAN,2011,8,29,0,77,8,0,122
JAMMU & KASHMIR,SOPORE,2011,4,38,0,58,9,5,114
JAMMU & KASHMIR,SRINAGAR,2011,14,110,0,171,70,54,419
JAMMU & KASHMIR,UDHAMPUR,2011,14,18,0,29,12,13,86
JAMMU & KASHMIR,TOTAL,2011,277,1023,11,1194,350,286,3141
JHARKHAND,BOKARO,2011,46,57,13,4,0,102,222
JHARKHAND,CHAIBASA,2011,32,14,6,5,0,11,68
JHARKHAND,CHATRA,2011,12,17,15,1,0,9,54
JHARKHAND,DEOGHAR,2011,34,10,18,16,1,24,103
JHARKHAND,DHANBAD,2011,32,83,39,34,0,39,227
JHARKHAND,DHANBAD RLY.,2011,0,1,3,8,0,1,13
JHARKHAND,DUMKA,2011,34,18,7,19,0,40,118
JHARKHAND,GARHWA,2011,51,26,19,22,0,89,207
JHARKHAND,GIRIDIH,2011,47,41,30,40,2,35,195
JHARKHAND,GODDA,2011,29,8,0,21,0,10,68
JHARKHAND,GUMLA,2011,46,27,1,10,0,17,101
JHARKHAND,HAZARIBAGH,2011,22,52,26,25,0,22,147
JHARKHAND,JAMSHEDPUR,2011,39,54,17,32,0,76,218
JHARKHAND,JAMSHEDPUR RLY.,2011,1,8,0,5,0,0,14
JHARKHAND,JAMTARA,2011,15,11,10,10,0,19,65
JHARKHAND,KHUNTI,2011,13,3,0,4,0,1,21
JHARKHAND,KODERMA,2011,7,19,16,7,0,34,83
JHARKHAND,LATEHAR,2011,27,12,2,4,0,11,56
JHARKHAND,LOHARDAGGA,2011,30,12,3,2,0,13,60
JHARKHAND,PAKUR,2011,39,8,0,6,0,22,75
JHARKHAND,PALAMU,2011,28,34,28,6,0,12,108
JHARKHAND,RAMGARH,2011,24,23,7,8,0,3,65
JHARKHAND,RANCHI,2011,50,54,8,9,2,14,137
JHARKHAND,SAHEBGANJ,2011,71,37,5,4,0,32,149
JHARKHAND,SARAIKELA,2011,30,16,8,9,2,13,78
JHARKHAND,SIMDEGA,2011,25,15,1,6,0,10,57
JHARKHAND,TOTAL,2011,784,660,282,317,7,659,2709
KARNATAKA,BAGALKOT,2011,15,9,0,38,0,58,120
KARNATAKA,BANGALORE COMMR.,2011,97,206,53,250,40,458,1104
KARNATAKA,BANGALORE RURAL,2011,29,1,10,74,2,83,199
KARNATAKA,BELGAUM,2011,45,32,11,221,4,297,610
KARNATAKA,BELLARY,2011,6,15,15,65,1,103,205
KARNATAKA,BIDAR,2011,14,11,7,27,2,77,138
KARNATAKA,BIJAPUR,2011,7,21,8,66,0,116,218
KARNATAKA,CBPURA,2011,16,16,7,55,0,92,186
KARNATAKA,CHAMARAJNAGAR,2011,11,6,9,71,0,62,159
KARNATAKA,CHICKMAGALUR,2011,10,11,1,53,4,68,147
KARNATAKA,CHITRADURGA,2011,27,24,5,93,0,96,245
KARNATAKA,DAKSHIN KANNADA,2011,6,3,1,46,0,38,94
KARNATAKA,DAVANAGERE,2011,11,15,6,65,0,93,190
KARNATAKA,DHARWAD COMMR.,2011,7,18,3,22,2,56,108
KARNATAKA,DHARWAD RURAL,2011,0,5,2,21,0,22,50
KARNATAKA,GADAG,2011,5,5,0,48,0,32,90
KARNATAKA,GULBARGA,2011,36,73,2,111,0,153,375
KARNATAKA,HASSAN,2011,27,25,32,106,0,264,454
KARNATAKA,HAVERI,2011,13,0,0,76,0,74,163
KARNATAKA,K.G.F.,2011,4,11,1,14,0,28,58
KARNATAKA,KODAGU,2011,16,5,5,25,1,57,109
KARNATAKA,KOLAR,2011,17,13,3,21,0,23,77
KARNATAKA,KOPPAL,2011,13,0,0,23,0,70,106
KARNATAKA,MANDYA,2011,31,31,12,98,0,230,402
KARNATAKA,MANGALORE CITY,2011,16,4,0,27,2,43,92
KARNATAKA,MYSORE COMMR.,2011,11,17,5,23,0,32,88
KARNATAKA,MYSORE RURAL,2011,19,39,7,174,0,158,397
KARNATAKA,RAICHUR,2011,29,14,10,149,0,174,376
KARNATAKA,RAILWAYS,2011,0,1,0,0,0,0,1
KARNATAKA,RAMANAGAR,2011,19,45,23,101,0,71,259
KARNATAKA,SHIMOGA,2011,23,18,6,123,10,278,458
KARNATAKA,TUMKUR,2011,31,14,17,135,0,124,321
KARNATAKA,UDUPI,2011,5,3,1,45,1,42,97
KARNATAKA,UTTAR KANNADA,2011,11,4,3,73,12,75,178
KARNATAKA,YADGIRI,2011,9,0,2,69,0,65,145
KARNATAKA,TOTAL,2011,636,715,267,2608,81,3712,8019
KERALA,ALAPUZHA,2011,56,10,1,245,76,310,698
KERALA,ERNAKULAM COMMR.,2011,62,4,1,149,44,225,485
KERALA,ERNAKULAM RURAL,2011,30,11,0,105,32,136,314
KERALA,IDUKKI,2011,54,8,0,169,18,237,486
KERALA,KANNUR,2011,55,11,0,161,23,373,623
KERALA,KASARGOD,2011,125,8,0,136,10,196,475
KERALA,KOLLAM COMMR.,2011,51,20,1,192,19,319,602
KERALA,KOLLAM RURAL,2011,46,10,0,255,8,298,617
KERALA,KOTTAYAM,2011,51,21,2,258,31,285,648
KERALA,KOZHIKODE COMMR.,2011,14,10,0,124,100,171,419
KERALA,KOZHIKODE RURAL,2011,46,16,1,179,13,322,577
KERALA,MALAPPURAM,2011,83,12,0,232,27,661,1015
KERALA,PALAKKAD,2011,85,9,2,156,18,404,674
KERALA,PATHANAMTHITTA,2011,33,15,0,157,14,158,377
KERALA,RAILWAYS,2011,0,0,0,25,9,0,34
KERALA,THRISSUR COMMR.,2011,28,10,0,100,28,131,297
KERALA,THRISSUR RURAL,2011,69,12,1,263,28,449,822
KERALA,TRIVANDRUM COMMR.,2011,39,13,0,241,46,156,495
KERALA,TRIVANDRUM RURAL,2011,140,15,4,547,24,422,1152
KERALA,WAYANADU,2011,65,6,2,62,5,124,264
KERALA,TOTAL,2011,1132,221,15,3756,573,5377,11074
MADHYA PRADESH,ALIRAJPUR,2011,24,18,0,23,0,8,73
MADHYA PRADESH,ANUPPUR,2011,60,7,10,57,4,42,180
MADHYA PRADESH,ASHOK NAGAR,2011,36,5,8,105,8,33,195
MADHYA PRADESH,BALAGHAT,2011,55,7,3,104,7,37,213
MADHYA PRADESH,BARWANI,2011,39,7,2,58,5,11,122
MADHYA PRADESH,BETUL,2011,120,18,20,188,6,53,405
MADHYA PRADESH,BHIND,2011,51,18,28,71,11,45,224
MADHYA PRADESH,BHOPAL,2011,146,32,19,144,16,198,555
MADHYA PRADESH,BHOPAL RLY.,2011,0,0,0,8,2,0,10
MADHYA PRADESH,BURHANPUR,2011,29,2,5,41,5,13,95
MADHYA PRADESH,CHHATARPUR,2011,77,42,33,185,8,75,420
MADHYA PRADESH,CHHINDWARA,2011,111,22,14,189,41,89,466
MADHYA PRADESH,DAMOH,2011,52,14,27,193,0,139,425
MADHYA PRADESH,DATIYA,2011,25,19,10,65,0,37,156
MADHYA PRADESH,DEWAS,2011,102,21,19,162,30,110,444
MADHYA PRADESH,DHAR,2011,103,41,62,189,13,74,482
MADHYA PRADESH,DINDORI,2011,46,4,1,67,5,21,144
MADHYA PRADESH,GUNA,2011,75,24,9,122,14,30,274
MADHYA PRADESH,GWALIOR,2011,75,81,34,170,14,168,542
MADHYA PRADESH,HARDA,2011,53,15,5,59,9,14,155
MADHYA PRADESH,HOSHANGABAD,2011,59,26,16,149,17,120,387
MADHYA PRADESH,INDORE,2011,129,52,41,339,59,398,1018
MADHYA PRADESH,INDORE RLY.,2011,2,1,1,4,0,0,8
MADHYA PRADESH,JABALPUR,2011,107,27,39,269,40,212,694
MADHYA PRADESH,JABALPUR RLY.,2011,3,2,1,3,0,0,9
MADHYA PRADESH,JHABUA,2011,42,17,4,62,0,10,135
MADHYA PRADESH,KATNI,2011,62,7,16,140,12,51,288
MADHYA PRADESH,KHANDWA,2011,59,10,5,141,19,24,258
MADHYA PRADESH,KHARGON,2011,39,13,38,118,14,38,260
MADHYA PRADESH,MANDLA,2011,63,9,4,101,12,27,216
MADHYA PRADESH,MANDSAUR,2011,49,18,4,100,6,58,235
MADHYA PRADESH,MORENA,2011,40,23,32,85,4,85,269
MADHYA PRADESH,NARSINGHPUR,2011,65,15,20,108,25,69,302
MADHYA PRADESH,NEEMUCH,2011,25,9,4,49,4,51,142
MADHYA PRADESH,PANNA,2011,48,5,14,87,5,48,207
MADHYA PRADESH,RAISEN,2011,118,22,15,179,16,67,417
MADHYA PRADESH,RAJGARH,2011,90,21,6,175,39,51,382
MADHYA PRADESH,RATLAM,2011,97,39,9,131,18,135,429
MADHYA PRADESH,REWA,2011,91,25,32,122,107,112,489
MADHYA PRADESH,SAGAR,2011,131,104,37,416,29,156,873
MADHYA PRADESH,SATNA,2011,83,13,20,177,7,109,409
MADHYA PRADESH,SEONI,2011,61,11,9,111,13,27,232
MADHYA PRADESH,SHAHDOL,2011,80,17,21,143,9,108,378
MADHYA PRADESH,SHAJAPUR,2011,50,10,8,135,17,7,227
MADHYA PRADESH,SHEOPUR,2011,18,7,2,28,2,9,66
MADHYA PRADESH,SHIVPURI,2011,93,18,13,168,5,65,362
MADHYA PRADESH,SIDHI,2011,32,31,16,93,1,45,218
MADHYA PRADESH,SIHORE,2011,82,26,11,119,14,76,328
MADHYA PRADESH,SINGRAULI,2011,43,24,13,89,1,59,229
MADHYA PRADESH,TIKAMGARH,2011,76,23,18,153,4,36,310
MADHYA PRADESH,UJJAIN,2011,81,35,14,196,36,176,538
MADHYA PRADESH,UMARIYA,2011,22,4,3,78,10,27,144
MADHYA PRADESH,VIDISHA,2011,87,27,16,197,19,79,425
MADHYA PRADESH,TOTAL,2011,3406,1088,811,6665,762,3732,16464
MAHARASHTRA,AHMEDNAGAR,2011,78,59,32,160,5,677,1011
MAHARASHTRA,AKOLA,2011,30,37,13,93,24,140,337
MAHARASHTRA,AMRAVATI COMMR.,2011,22,19,2,49,13,94,199
MAHARASHTRA,AMRAVATI RURAL,2011,69,27,3,142,43,104,388
MAHARASHTRA,AURANGABAD COMMR.,2011,16,24,7,65,29,122,263
MAHARASHTRA,AURANGABAD RURAL,2011,18,12,36,78,12,212,368
MAHARASHTRA,BEED,2011,32,37,11,99,14,378,571
MAHARASHTRA,BHANDARA,2011,23,9,1,30,14,50,127
MAHARASHTRA,BULDHANA,2011,26,27,14,124,24,194,409
MAHARASHTRA,CHANDRAPUR,2011,56,25,4,108,77,109,379
MAHARASHTRA,DHULE,2011,16,27,4,52,7,203,309
MAHARASHTRA,GADCHIROLI,2011,20,3,0,24,3,23,73
MAHARASHTRA,GONDIA,2011,31,23,1,67,19,36,177
MAHARASHTRA,HINGOLI,2011,18,8,0,42,5,82,155
MAHARASHTRA,JALGAON,2011,48,25,8,146,51,364,642
MAHARASHTRA,JALNA,2011,15,17,23,73,10,289,427
MAHARASHTRA,KOLHAPUR,2011,42,35,19,59,18,121,294
MAHARASHTRA,LATUR,2011,17,37,4,57,0,156,271
MAHARASHTRA,MUMBAI COMMR.,2011,221,166,14,553,162,393,1509
MAHARASHTRA,MUMBAI RLY.,2011,3,6,0,8,3,0,20
MAHARASHTRA,NAGPUR COMMR.,2011,45,24,4,68,53,174,368
MAHARASHTRA,NAGPUR RLY.,2011,1,0,0,9,1,1,12
MAHARASHTRA,NAGPUR RURAL,2011,44,24,11,65,15,62,221
MAHARASHTRA,NANDED,2011,32,43,29,93,3,325,525
MAHARASHTRA,NANDURBAR,2011,20,15,0,40,7,87,169
MAHARASHTRA,NASIK COMMR.,2011,25,11,5,37,10,115,203
MAHARASHTRA,NASIK RURAL,2011,43,28,5,91,33,298,498
MAHARASHTRA,NAVI MUMBAI,2011,38,17,1,57,33,110,256
MAHARASHTRA,OSMANABAD,2011,30,18,2,88,11,186,335
MAHARASHTRA,PARBHANI,2011,26,16,5,80,6,215,348
MAHARASHTRA,PUNE COMMR.,2011,79,72,8,118,80,251,608
MAHARASHTRA,PUNE RLY.,2011,0,0,0,4,0,0,4
MAHARASHTRA,PUNE RURAL,2011,87,48,16,122,26,172,471
MAHARASHTRA,RAIGAD,2011,7,5,2,42,15,42,113
MAHARASHTRA,RATNAGIRI,2011,30,10,1,35,18,49,143
MAHARASHTRA,SANGLI,2011,40,13,5,51,8,98,215
MAHARASHTRA,SATARA,2011,34,36,2,80,16,179,347
MAHARASHTRA,SINDHUDURG,2011,11,7,0,8,12,5,43
MAHARASHTRA,SOLAPUR COMMR.,2011,22,18,0,31,9,68,148
MAHARASHTRA,SOLAPUR RURAL,2011,53,32,6,94,32,175,392
MAHARASHTRA,THANE COMMR.,2011,79,70,8,161,38,342,698
MAHARASHTRA,THANE RURAL,2011,63,32,10,105,18,57,285
MAHARASHTRA,WARDHA,2011,34,23,3,88,45,62,255
MAHARASHTRA,WASHIM,2011,13,21,12,80,12,118,256
MAHARASHTRA,YAVATMAL,2011,44,46,8,118,37,198,451
MAHARASHTRA,TOTAL,2011,1701,1252,339,3794,1071,7136,15293
MANIPUR,BISHNUPUR,2011,2,11,0,11,0,3,27
MANIPUR,CHANDEL,2011,1,0,0,0,0,0,1
MANIPUR,CHURACHANDPUR,2011,0,3,0,0,0,1,4
MANIPUR,CID,2011,0,0,0,0,0,0,0
MANIPUR,IMPHAL EAST,2011,11,28,0,7,0,8,54
MANIPUR,IMPHAL WEST,2011,17,45,1,11,0,8,82
MANIPUR,SENAPATI,2011,0,1,0,0,0,0,1
MANIPUR,TAMENGLONG,2011,0,0,0,1,0,0,1
MANIPUR,THOUBAL,2011,21,28,0,8,0,19,76
MANIPUR,UKHRUL,2011,1,0,0,0,0,0,1
MANIPUR,TOTAL,2011,53,116,1,38,0,39,247
MEGHALAYA,GARO HILLS EAST,2011,3,0,0,0,0,0,3
MEGHALAYA,GARO HILLS SOUTH,2011,2,4,0,2,0,1,9
MEGHALAYA,GARO HILLS WEST,2011,8,9,1,22,1,8,49
MEGHALAYA,JAINTIA HILLS,2011,43,8,0,6,0,0,57
MEGHALAYA,KHASI HILLS EAST,2011,42,8,0,32,0,11,93
MEGHALAYA,KHASI HILLS WEST,2011,15,5,0,8,0,0,28
MEGHALAYA,RI-BHOI,2011,17,3,0,4,0,1,25
MEGHALAYA,TOTAL,2011,130,37,1,74,1,21,264
MIZORAM,AIZAWL,2011,35,0,0,43,0,9,87
MIZORAM,CHAMPHAI,2011,10,0,0,10,0,0,20
MIZORAM,KOLASIB,2011,7,0,0,3,1,0,11
MIZORAM,LAWNGTLAI,2011,2,0,0,0,0,0,2
MIZORAM,LUNGLEI,2011,13,0,0,3,0,0,16
MIZORAM,MAMIT,2011,4,0,0,4,0,0,8
MIZORAM,SAIHA,2011,2,0,0,5,0,0,7
MIZORAM,SERCHHIP,2011,4,0,0,4,0,0,8
MIZORAM,TOTAL,2011,77,0,0,72,1,9,159
NAGALAND,DIMAPUR,2011,9,1,0,7,0,1,18
NAGALAND,KIPHIRE,2011,0,0,0,0,0,0,0
NAGALAND,KOHIMA,2011,0,0,0,0,0,0,0
NAGALAND,LONGLENG,2011,1,0,0,0,0,0,1
NAGALAND,MOKOKCHUNG,2011,2,1,0,0,0,0,3
NAGALAND,MON,2011,2,0,0,0,0,0,2
NAGALAND,PEREN,2011,0,0,0,0,0,0,0
NAGALAND,PHEK,2011,3,0,0,2,0,0,5
NAGALAND,TUENSANG,2011,2,0,0,0,0,0,2
NAGALAND,WOKHA,2011,1,0,0,0,0,0,1
NAGALAND,ZUNHEBOTO,2011,3,1,0,0,0,0,4
NAGALAND,TOTAL,2011,23,3,0,9,0,1,36
ODISHA,ANGUL,2011,63,39,25,299,8,58,492
ODISHA,BALASORE,2011,75,97,45,217,19,279,732
ODISHA,BARAGARH,2011,21,11,16,91,18,99,256
ODISHA,BERHAMPUR,2011,13,15,9,154,12,86,289
ODISHA,BHADRAK,2011,26,51,24,93,4,138,336
ODISHA,BOLANGIR,2011,52,24,6,166,4,44,296
ODISHA,BOUDH,2011,14,16,0,56,5,15,106
ODISHA,CUTTACK,2011,34,40,24,26,5,133,262
ODISHA,DCP BBSR,2011,35,32,13,43,5,32,160
ODISHA,DCP CTC,2011,19,25,0,17,2,88,151
ODISHA,DEOGARH,2011,15,8,2,68,1,6,100
ODISHA,DHENKANAL,2011,17,29,22,185,11,24,288
ODISHA,GAJAPATI,2011,11,6,0,56,3,20,96
ODISHA,GANJAM,2011,50,39,32,358,15,0,494
ODISHA,JAGATSINGHPUR,2011,31,42,18,12,0,75,178
ODISHA,JAJPUR,2011,31,44,30,94,9,97,305
ODISHA,JHARSUGUDA,2011,27,12,7,45,4,17,112
ODISHA,KALAHANDI,2011,46,22,9,97,11,95,280
ODISHA,KANDHAMAL,2011,32,21,9,70,8,41,181
ODISHA,KENDRAPARA,2011,41,43,36,14,1,147,282
ODISHA,KEONJHAR,2011,75,44,22,134,11,110,396
ODISHA,KHURDA,2011,29,27,10,14,2,139,221
ODISHA,KORAPUT,2011,53,36,0,126,10,48,273
ODISHA,MALKANGIR,2011,8,10,6,46,7,19,96
ODISHA,MAYURBHANJ,2011,76,87,34,227,20,143,587
ODISHA,NAYAGARH,2011,25,26,16,4,1,89,161
ODISHA,NOWRANGPUR,2011,44,44,2,80,13,43,226
ODISHA,NUAPADA,2011,4,10,2,51,6,20,93
ODISHA,PURI,2011,21,27,27,16,1,98,190
ODISHA,RAYAGADA,2011,32,34,7,106,6,38,223
ODISHA,ROURKELA,2011,26,19,1,63,6,31,146
ODISHA,SAMBALPUR,2011,30,12,2,48,2,29,123
ODISHA,SONEPUR,2011,10,4,3,48,1,9,75
ODISHA,SRP(CUTTACK),2011,0,0,0,8,1,0,9
ODISHA,SRP(ROURKELA),2011,1,0,1,9,1,3,15
ODISHA,SUNDARGARH,2011,25,12,5,66,2,7,117
ODISHA,TOTAL,2011,1112,1008,465,3207,235,2320,8347
PUNJAB,AMRITSAR,2011,16,20,1,16,0,58,111
PUNJAB,BARNALA,2011,5,5,3,6,0,10,29
PUNJAB,BATALA,2011,13,14,4,8,0,35,74
PUNJAB,BHATINDA,2011,37,20,5,11,1,49,123
PUNJAB,CP AMRITSAR,2011,20,34,4,7,1,101,167
PUNJAB,CP JALANDHAR,2011,15,40,4,19,3,74,155
PUNJAB,CP LUDHIANA,2011,48,76,14,25,12,109,284
PUNJAB,FARIDKOT,2011,8,6,1,10,0,20,45
PUNJAB,FATEHGARH SAHIB,2011,4,8,4,4,1,21,42
PUNJAB,FAZILKA,2011,21,17,3,5,0,29,75
PUNJAB,FEROZPUR,2011,20,25,6,9,0,53,113
PUNJAB,G.R.P,2011,0,0,0,0,0,0,0
PUNJAB,GURDASPUR,2011,12,22,6,17,0,38,95
PUNJAB,HOSHIARPUR,2011,28,23,11,13,2,72,149
PUNJAB,JALANDHAR,2011,31,26,6,22,0,57,142
PUNJAB,KAPURTHALA,2011,16,17,2,10,0,39,84
PUNJAB,KHANNA,2011,7,8,1,6,0,10,32
PUNJAB,LUDHIANA,2011,8,10,4,4,4,22,52
PUNJAB,MANSA,2011,14,5,4,5,0,13,41
PUNJAB,MOGA,2011,12,12,5,3,0,26,58
PUNJAB,MUKTSAR,2011,17,14,7,8,0,16,62
PUNJAB,PATHANKOT,2011,10,12,5,2,0,21,50
PUNJAB,PATIALA,2011,25,26,13,22,0,95,181
PUNJAB,ROPAR,2011,14,16,5,9,1,18,63
PUNJAB,SANGRUR,2011,30,11,14,10,0,36,101
PUNJAB,SAS NGR,2011,24,27,4,13,3,76,147
PUNJAB,SBS NAGAR,2011,8,6,4,6,3,14,41
PUNJAB,TARN TARAN,2011,16,17,3,12,0,24,72
PUNJAB,TOTAL,2011,479,517,143,282,31,1136,2588
RAJASTHAN,AJMER,2011,70,108,15,105,0,709,1007
RAJASTHAN,ALWAR,2011,99,143,53,136,0,556,987
RAJASTHAN,BANSWARA,2011,55,95,6,59,2,190,407
RAJASTHAN,BARAN,2011,60,88,10,158,1,351,668
RAJASTHAN,BARMER,2011,21,34,27,36,0,201,319
RAJASTHAN,BHARATPUR,2011,69,139,29,85,0,478,800
RAJASTHAN,BHILWARA,2011,52,74,16,90,0,558,790
RAJASTHAN,BIKANER,2011,55,25,17,54,0,446,597
RAJASTHAN,BUNDI,2011,40,99,6,114,0,298,557
RAJASTHAN,CHITTORGARH,2011,50,98,4,48,1,588,789
RAJASTHAN,CHURU,2011,37,26,10,11,0,342,426
RAJASTHAN,DAUSA,2011,13,72,12,17,0,184,298
RAJASTHAN,DHOLPUR,2011,32,64,19,12,0,197,324
RAJASTHAN,DUNGARPUR,2011,39,87,5,57,0,134,322
RAJASTHAN,G.R.P.AJMER,2011,2,6,0,9,0,0,17
RAJASTHAN,G.R.P.JODHPUR,2011,0,1,0,7,0,0,8
RAJASTHAN,GANGANAGAR,2011,99,68,19,73,1,653,913
RAJASTHAN,HANUMANGARH,2011,82,38,12,66,0,405,603
RAJASTHAN,JAIPUR EAST,2011,31,69,15,59,0,272,446
RAJASTHAN,JAIPUR NORTH,2011,20,38,8,23,0,241,330
RAJASTHAN,JAIPUR RURAL,2011,37,75,15,37,0,213,377
RAJASTHAN,JAIPUR SOUTH,2011,18,47,6,18,0,215,304
RAJASTHAN,JAIPUR WEST,2011,23,72,10,25,0,208,338
RAJASTHAN,JAISALMER,2011,4,5,5,17,0,20,51
RAJASTHAN,JALORE,2011,22,47,14,24,0,154,261
RAJASTHAN,JHALAWAR,2011,67,55,14,201,3,385,725
RAJASTHAN,JHUNJHUNU,2011,51,59,21,68,0,284,483
RAJASTHAN,JODHPUR CITY,2011,33,45,13,57,1,338,487
RAJASTHAN,JODHPUR RURAL,2011,26,35,17,28,0,133,239
RAJASTHAN,KARAULI,2011,38,78,18,18,0,174,326
RAJASTHAN,KOTA CITY,2011,24,74,5,58,0,413,574
RAJASTHAN,KOTA RURAL,2011,44,50,5,98,0,235,432
RAJASTHAN,NAGAUR,2011,70,60,14,66,0,398,608
RAJASTHAN,PALI,2011,64,88,11,84,0,451,698
RAJASTHAN,PRATAPGARH,2011,103,77,7,65,0,212,464
RAJASTHAN,RAJSAMAND,2011,14,44,2,61,0,234,355
RAJASTHAN,SAWAI MADHOPUR,2011,24,72,4,43,0,201,344
RAJASTHAN,SIKAR,2011,50,69,26,11,0,232,388
RAJASTHAN,SIROHI,2011,27,52,5,76,0,156,316
RAJASTHAN,TONK,2011,25,75,5,23,0,315,443
RAJASTHAN,UDAIPUR,2011,110,162,14,150,0,444,880
RAJASTHAN,TOTAL,2011,1800,2713,514,2447,9,12218,19701
SIKKIM,EAST,2011,7,5,0,6,0,2,20
SIKKIM,NORTH,2011,0,0,0,1,0,0,1
SIKKIM,SOUTH,2011,4,4,0,11,0,1,20
SIKKIM,WEST,2011,5,1,0,6,0,1,13
SIKKIM,TOTAL,2011,16,10,0,24,0,4,54
TAMIL NADU,ARIYALUR,2011,16,17,1,47,3,15,99
TAMIL NADU,CHENNAI,2011,76,41,20,73,121,229,560
TAMIL NADU,CHENNAI RLY.,2011,0,1,1,6,5,0,13
TAMIL NADU,COIMBATORE RURAL,2011,5,29,1,43,0,50,128
TAMIL NADU,COIMBATORE URBAN,2011,9,10,2,32,5,83,141
TAMIL NADU,CUDDALORE,2011,30,102,16,12,0,57,217
TAMIL NADU,DHARMAPURI,2011,14,61,0,44,0,53,172
TAMIL NADU,DINDIGUL,2011,18,50,3,45,0,117,233
TAMIL NADU,ERODE,2011,10,35,1,35,3,19,103
TAMIL NADU,KANCHIPURAM,2011,19,22,1,25,4,25,96
TAMIL NADU,KANYAKUMARI,2011,10,50,3,7,137,90,297
TAMIL NADU,KARUR,2011,8,56,1,21,3,22,111
TAMIL NADU,KRISHNAGIRI,2011,12,52,7,32,1,29,133
TAMIL NADU,MADURAI RURAL,2011,21,88,12,68,3,73,265
TAMIL NADU,MADURAI URBAN,2011,7,18,5,22,4,71,127
TAMIL NADU,NAGAPATTINAM,2011,13,32,5,40,27,12,129
TAMIL NADU,NAMAKKAL,2011,8,55,1,58,12,14,148
TAMIL NADU,NILGIRIS,2011,6,7,0,8,2,4,27
TAMIL NADU,PERAMBALUR,2011,7,25,1,18,0,3,54
TAMIL NADU,PUDUKOTTAI,2011,7,41,0,24,2,18,92
TAMIL NADU,RAMNATHAPURAM,2011,6,51,1,14,0,9,81
TAMIL NADU,SALEM RURAL,2011,35,100,4,108,0,51,298
TAMIL NADU,SALEM URBAN,2011,23,35,2,21,9,38,128
TAMIL NADU,SIVAGANGAI,2011,5,30,1,33,1,43,113
TAMIL NADU,THANJAVUR,2011,10,43,1,76,0,12,142
TAMIL NADU,THENI,2011,22,79,12,40,0,89,242
TAMIL NADU,THIRUNELVELI RURAL,2011,52,46,8,57,0,120,283
TAMIL NADU,THIRUNELVELI URBAN,2011,7,13,0,7,0,2,29
TAMIL NADU,THIRUVALLUR,2011,6,10,7,2,1,12,38
TAMIL NADU,THIRUVANNAMALAI,2011,24,59,3,11,0,11,108
TAMIL NADU,THIRUVARUR,2011,4,20,2,8,0,6,40
TAMIL NADU,THOOTHUGUDI,2011,29,35,4,2,0,40,110
TAMIL NADU,TIRUPPUR,2011,9,43,9,42,0,89,192
TAMIL NADU,TRICHY RLY.,2011,0,0,0,3,1,1,5
TAMIL NADU,TRICHY RURAL,2011,13,52,2,38,0,35,140
TAMIL NADU,TRICHY URBAN,2011,6,21,2,17,26,28,100
TAMIL NADU,VELLORE,2011,25,78,5,29,0,44,181
TAMIL NADU,VILLUPURAM,2011,86,187,7,274,0,140,694
TAMIL NADU,VIRUDHUNAGAR,2011,19,49,1,25,94,58,246
TAMIL NADU,TOTAL,2011,677,1743,152,1467,464,1812,6315
TRIPURA,DHALAI,2011,21,9,1,38,0,52,121
TRIPURA,GRP,2011,0,0,0,0,0,0,0
TRIPURA,NORTH,2011,40,27,1,50,1,172,291
TRIPURA,SOUTH,2011,58,24,5,84,1,181,353
TRIPURA,WEST,2011,86,56,23,122,7,297,591
TRIPURA,TOTAL,2011,205,116,30,294,9,702,1356
UTTAR PRADESH,AGRA,2011,76,328,87,196,0,341,1028
UTTAR PRADESH,ALIGARH,2011,66,265,73,194,0,256,854
UTTAR PRADESH,ALLAHABAD,2011,67,190,75,93,1,266,692
UTTAR PRADESH,AMBEDKAR NAGAR,2011,16,74,16,33,0,88,227
UTTAR PRADESH,AURAIYA,2011,15,73,25,14,0,26,153
UTTAR PRADESH,AZAMGARH,2011,28,101,27,27,0,49,232
UTTAR PRADESH,BADAUN,2011,18,115,48,62,0,59,302
UTTAR PRADESH,BAGHPAT,2011,12,74,17,35,0,106,244
UTTAR PRADESH,BAHRAICH,2011,57,128,62,49,0,55,351
UTTAR PRADESH,BALLIA,2011,7,64,17,21,0,27,136
UTTAR PRADESH,BALRAMPUR,2011,10,50,16,13,0,0,89
UTTAR PRADESH,BANDA,2011,26,48,29,56,0,31,190
UTTAR PRADESH,BARABANKI,2011,36,142,25,51,0,51,305
UTTAR PRADESH,BAREILLY,2011,34,193,63,92,0,155,537
UTTAR PRADESH,BASTI,2011,7,28,11,5,0,17,68
UTTAR PRADESH,BHIM NAGAR,2011,34,105,29,43,0,61,272
UTTAR PRADESH,BIJNOR,2011,39,118,30,14,0,238,439
UTTAR PRADESH,BULANDSHAHAR,2011,47,192,50,94,0,362,745
UTTAR PRADESH,CHANDOLI,2011,8,19,17,7,0,48,99
UTTAR PRADESH,CHITRAKOOT DHAM,2011,20,22,14,24,0,11,91
UTTAR PRADESH,CSM NAGAR,2011,20,96,17,40,0,53,226
UTTAR PRADESH,DEORIA,2011,8,53,27,12,0,24,124
UTTAR PRADESH,ETAH,2011,19,61,30,25,0,57,192
UTTAR PRADESH,ETAWAH,2011,13,73,42,28,0,52,208
UTTAR PRADESH,FAIZABAD,2011,27,114,11,56,0,21,229
UTTAR PRADESH,FATEHGARH,2011,16,83,25,35,0,59,218
UTTAR PRADESH,FATEHPUR,2011,40,92,45,55,0,45,277
UTTAR PRADESH,FIROZABAD,2011,32,144,43,57,0,83,359
UTTAR PRADESH,G.R.P.,2011,2,6,1,38,0,0,47
UTTAR PRADESH,GAUTAMBUDH NAGAR,2011,25,95,25,42,0,102,289
UTTAR PRADESH,GHAZIABAD,2011,22,219,47,59,0,255,602
UTTAR PRADESH,GHAZIPUR,2011,11,18,35,16,0,26,106
UTTAR PRADESH,GONDA,2011,34,116,27,29,0,6,212
UTTAR PRADESH,GORAKHPUR,2011,50,215,41,71,0,224,601
UTTAR PRADESH,HAMIRPUR,2011,12,38,15,33,0,20,118
UTTAR PRADESH,HARDOI,2011,24,123,32,55,0,72,306
UTTAR PRADESH,HATHRAS,2011,35,77,24,42,0,84,262
UTTAR PRADESH,J.P.NAGAR,2011,44,50,16,21,0,83,214
UTTAR PRADESH,JALAUN,2011,7,47,40,18,0,22,134
UTTAR PRADESH,JAUNPUR,2011,14,90,42,22,0,41,209
UTTAR PRADESH,JHANSI,2011,19,92,28,45,0,52,236
UTTAR PRADESH,KANNAUJ,2011,14,101,34,49,0,98,296
UTTAR PRADESH,KANPUR NAGAR,2011,71,303,69,140,2,284,869
UTTAR PRADESH,KANSHIRAM NAGAR,2011,22,47,22,33,0,21,145
UTTAR PRADESH,KAUSHAMBI,2011,23,40,22,36,0,31,152
UTTAR PRADESH,KHIRI,2011,35,132,57,76,0,57,357
UTTAR PRADESH,KUSHI NAGAR,2011,13,75,35,11,0,31,165
UTTAR PRADESH,LALITPUR,2011,15,30,14,52,0,26,137
UTTAR PRADESH,LUCKNOW,2011,55,283,48,142,0,511,1039
UTTAR PRADESH,MAHARAJGANJ,2011,18,42,26,15,0,12,113
UTTAR PRADESH,MAHOBA,2011,16,31,15,41,0,31,134
UTTAR PRADESH,MAINPURI,2011,33,92,34,52,0,52,263
UTTAR PRADESH,MATHURA,2011,39,123,36,76,0,226,500
UTTAR PRADESH,MAU,2011,19,60,7,31,0,64,181
UTTAR PRADESH,MEERUT,2011,79,271,36,99,0,400,885
UTTAR PRADESH,MIRZAPUR,2011,3,5,20,3,0,34,65
UTTAR PRADESH,MORADABAD,2011,55,174,30,48,0,210,517
UTTAR PRADESH,MUZAFFARNAGAR,2011,19,179,25,37,0,203,463
UTTAR PRADESH,PANCHSHIL NAGAR,2011,18,78,15,25,0,72,208
UTTAR PRADESH,PILIBHIT,2011,12,62,39,31,0,69,213
UTTAR PRADESH,PRABUDDH NAGAR,2011,11,52,10,13,0,83,169
UTTAR PRADESH,PRATAPGARH,2011,24,85,31,35,0,121,296
UTTAR PRADESH,RAIBAREILLY,2011,29,55,16,36,0,51,187
UTTAR PRADESH,RAMABAI NAGAR,2011,21,83,29,35,0,65,233
UTTAR PRADESH,RAMPUR,2011,43,98,26,27,0,86,280
UTTAR PRADESH,SAHARANPUR,2011,21,82,32,16,0,135,286
UTTAR PRADESH,SANT KABIRNAGAR,2011,17,48,6,12,0,19,102
UTTAR PRADESH,SHAHJAHANPUR,2011,40,130,47,54,0,28,299
UTTAR PRADESH,SHRAWASTI,2011,16,36,16,26,0,1,95
UTTAR PRADESH,SIDHARTHNAGAR,2011,9,42,17,21,0,29,118
UTTAR PRADESH,SITAPUR,2011,66,202,60,131,0,138,597
UTTAR PRADESH,SONBHADRA,2011,19,21,8,21,0,16,85
UTTAR PRADESH,ST.RAVIDASNAGAR,2011,2,6,11,3,0,10,32
UTTAR PRADESH,SULTANPUR,2011,21,46,14,23,0,58,162
UTTAR PRADESH,UNNAO,2011,36,104,30,66,0,85,321
UTTAR PRADESH,VARANASI,2011,11,76,41,17,0,136,281
UTTAR PRADESH,TOTAL,2011,2042,7525,2322,3455,3,7121,22468
UTTARAKHAND,ALMORA,2011,3,2,6,4,0,6,21
UTTARAKHAND,BAGESHWAR,2011,2,2,2,2,1,4,13
UTTARAKHAND,CHAMOLI,2011,2,1,0,2,0,2,7
UTTARAKHAND,CHAMPAWAT,2011,4,3,0,2,0,4,13
UTTARAKHAND,DEHRADUN,2011,31,47,10,16,38,101,243
UTTARAKHAND,HARIDWAR,2011,26,75,22,30,22,58,233
UTTARAKHAND,NAINITAL,2011,10,24,15,4,5,19,77
UTTARAKHAND,PAURI GARHWAL,2011,1,4,2,6,1,6,20
UTTARAKHAND,PITHORAGARH,2011,9,4,5,8,0,5,31
UTTARAKHAND,RUDRA PRAYAG,2011,3,4,3,6,3,6,25
UTTARAKHAND,TEHRI GARHWAL,2011,3,1,1,1,0,1,7
UTTARAKHAND,UDHAMSINGH NAGAR,2011,31,114,17,33,0,94,289
UTTARAKHAND,UTTARKASHI,2011,4,2,0,2,2,1,11
UTTARAKHAND,TOTAL,2011,129,283,83,116,72,307,990
WEST BENGAL,24 PARGANAS NORTH,2011,203,414,88,218,10,2847,3780
WEST BENGAL,24 PARGANAS SOUTH,2011,274,349,43,121,3,2793,3583
WEST BENGAL,ASANSOL,2011,31,50,10,30,7,461,589
WEST BENGAL,BANKURA,2011,44,36,16,83,1,195,375
WEST BENGAL,BIRBHUM,2011,44,51,25,63,0,337,520
WEST BENGAL,BURDWAN,2011,52,83,16,21,0,665,837
WEST BENGAL,COOCHBEHAR,2011,133,174,25,76,0,494,902
WEST BENGAL,DAKSHIN DINAJPUR,2011,55,111,11,77,5,283,542
WEST BENGAL,DARJEELING,2011,49,88,4,51,6,337,535
WEST BENGAL,HOOGHLY,2011,54,109,21,38,0,816,1038
WEST BENGAL,HOWRAH,2011,35,114,26,75,16,644,910
WEST BENGAL,HOWRAH CITY,2011,24,103,2,2,0,411,542
WEST BENGAL,HOWRAH G.R.P.,2011,1,6,0,5,0,1,13
WEST BENGAL,JALPAIGURI,2011,211,257,13,223,0,947,1651
WEST BENGAL,KHARAGPUR G.R.P.,2011,0,0,0,5,0,1,6
WEST BENGAL,KOLKATA,2011,46,116,11,254,144,557,1128
WEST BENGAL,MALDA,2011,179,202,14,38,0,762,1195
WEST BENGAL,MURSHIDABAD,2011,433,492,49,621,5,2956,4556
WEST BENGAL,NADIA,2011,185,453,65,128,2,1923,2756
WEST BENGAL,PASCHIM MIDNAPUR,2011,53,141,27,89,0,803,1113
WEST BENGAL,PURAB MIDNAPUR,2011,65,156,22,18,0,835,1096
WEST BENGAL,PURULIA,2011,65,52,3,64,0,197,381
WEST BENGAL,SEALDAH G.R.P.,2011,1,4,0,7,0,1,13
WEST BENGAL,SILIGURI G.R.P.,2011,0,1,0,4,0,0,5
WEST BENGAL,UTTAR DINAJPUR,2011,126,149,19,52,1,506,853
WEST BENGAL,TOTAL,2011,2363,3711,510,2363,200,19772,28919
A & N ISLANDS,ANDAMAN,2011,13,12,0,14,3,5,47
A & N ISLANDS,NICOBAR,2011,0,0,0,1,0,0,1
A & N ISLANDS,TOTAL,2011,13,12,0,15,3,5,48
CHANDIGARH,CHANDIGARH,2011,27,46,2,21,12,46,154
CHANDIGARH,TOTAL,2011,27,46,2,21,12,46,154
D & N HAVELI,D and N HAVELI,2011,4,8,0,2,0,3,17
D & N HAVELI,TOTAL,2011,4,8,0,2,0,3,17
DAMAN & DIU,DAMAN,2011,1,1,0,0,0,2,4
DAMAN & DIU,DIU,2011,0,1,0,0,0,0,1
DAMAN & DIU,TOTAL,2011,1,2,0,0,0,2,5
DELHI,CAW,2011,1,0,0,1,0,128,130
DELHI,CENTRAL,2011,16,89,3,32,4,29,173
DELHI,CRIME BRANCH,2011,1,0,0,0,0,0,1
DELHI,DELHI UT TOTAL,2011,572,2085,142,657,162,1575,5193
DELHI,EAST,2011,55,226,14,78,17,160,550
DELHI,EOW,2011,0,0,0,0,0,0,0
DELHI,GRP(RLY),2011,4,10,1,7,1,0,23
DELHI,IGI AIRPORT,2011,0,0,0,8,2,0,10
DELHI,NEW DELHI,2011,2,17,1,17,12,5,54
DELHI,NORTH,2011,11,84,4,15,10,88,212
DELHI,NORTH-EAST,2011,69,285,21,88,21,254,738
DELHI,NORTH-WEST,2011,58,177,10,48,13,117,423
DELHI,OUTER,2011,73,328,34,65,3,196,699
DELHI,SOUTH,2011,65,143,11,50,29,59,357
DELHI,SOUTH-EAST,2011,75,234,19,127,32,108,595
DELHI,SOUTH-WEST,2011,69,238,11,56,10,144,528
DELHI,STF,2011,0,0,0,0,0,0,0
DELHI,WEST,2011,73,254,13,65,8,287,700
LAKSHADWEEP,LAKSHADWEEP,2011,0,0,0,0,0,0,0
LAKSHADWEEP,TOTAL,2011,0,0,0,0,0,0,0
PUDUCHERRY,KARAIKAL,2011,0,0,0,10,4,1,15
PUDUCHERRY,PUDUCHERRY,2011,7,9,1,25,12,9,63
PUDUCHERRY,TOTAL,2011,7,9,1,35,16,10,78
ANDHRA PRADESH,ADILABAD,2012,88,61,7,90,155,498,899
ANDHRA PRADESH,ANANTAPUR,2012,18,63,19,195,8,130,433
ANDHRA PRADESH,CHITTOOR,2012,28,49,33,90,269,339,808
ANDHRA PRADESH,CUDDAPAH,2012,26,44,13,217,37,120,457
ANDHRA PRADESH,CYBERABAD,2012,75,102,45,183,282,976,1663
ANDHRA PRADESH,EAST GODAVARI,2012,71,40,17,248,160,536,1072
ANDHRA PRADESH,GUNTAKAL RLY.,2012,1,0,1,1,1,2,6
ANDHRA PRADESH,GUNTUR,2012,23,53,21,252,83,656,1088
ANDHRA PRADESH,GUNTUR URBAN,2012,24,32,9,84,83,687,919
ANDHRA PRADESH,HYDERABAD CITY,2012,74,31,23,145,141,1339,1753
ANDHRA PRADESH,KARIMNAGAR,2012,40,98,46,224,232,759,1399
ANDHRA PRADESH,KHAMMAM,2012,78,62,13,233,172,231,789
ANDHRA PRADESH,KRISHNA,2012,67,55,16,341,309,791,1579
ANDHRA PRADESH,KURNOOL,2012,22,46,15,331,75,166,655
ANDHRA PRADESH,MAHABOOBNAGAR,2012,56,70,27,154,45,204,556
ANDHRA PRADESH,MEDAK,2012,26,45,20,112,55,475,733
ANDHRA PRADESH,NALGONDA,2012,52,79,20,246,264,302,963
ANDHRA PRADESH,NELLORE,2012,23,72,9,210,142,405,861
ANDHRA PRADESH,NIZAMABAD,2012,35,23,19,100,102,596,875
ANDHRA PRADESH,PRAKASHAM,2012,37,69,16,213,47,263,645
ANDHRA PRADESH,RAJAHMUNDRY,2012,13,5,3,49,35,183,288
ANDHRA PRADESH,RANGA REDDY,2012,27,21,16,58,31,152,305
ANDHRA PRADESH,SECUNDERABAD RLY.,2012,2,0,0,5,5,0,12
ANDHRA PRADESH,SRIKAKULAM,2012,39,18,3,116,69,312,557
ANDHRA PRADESH,TIRUPATHI URBAN,2012,12,14,6,21,11,96,160
ANDHRA PRADESH,VIJAYAWADA CITY,2012,47,39,16,223,418,1136,1879
ANDHRA PRADESH,VIJAYAWADA RLY.,2012,0,3,0,5,6,1,15
ANDHRA PRADESH,VISAKHA RURAL,2012,27,13,9,67,20,134,270
ANDHRA PRADESH,VISAKHAPATNAM,2012,50,20,11,23,11,412,527
ANDHRA PRADESH,VIZIANAGARAM,2012,44,20,3,96,103,363,629
ANDHRA PRADESH,WARANGAL,2012,56,58,20,117,34,101,386
ANDHRA PRADESH,WARANGAL URBAN,2012,30,39,9,71,74,267,490
ANDHRA PRADESH,WEST GODAVARI,2012,130,59,19,296,235,757,1496
ANDHRA PRADESH,TOTAL,2012,1341,1403,504,4816,3714,13389,25167
ARUNACHAL PRADESH,ANJAW,2012,0,1,0,0,0,0,1
ARUNACHAL PRADESH,CHANGLANG,2012,6,7,1,5,0,4,23
ARUNACHAL PRADESH,DIBANG VALLEY,2012,2,4,0,2,0,1,9
ARUNACHAL PRADESH,K/KUMEY,2012,2,1,0,1,0,0,4
ARUNACHAL PRADESH,KAMENG EAST,2012,6,2,0,1,0,0,9
ARUNACHAL PRADESH,KAMENG WEST,2012,0,1,0,1,0,2,4
ARUNACHAL PRADESH,LOHIT,2012,3,5,0,11,0,2,21
ARUNACHAL PRADESH,PAPUM PARE,2012,7,15,0,8,2,3,35
ARUNACHAL PRADESH,RURAL,2012,6,3,0,8,0,1,18
ARUNACHAL PRADESH,SIANG EAST,2012,6,0,0,4,0,1,11
ARUNACHAL PRADESH,SIANG UPPER,2012,1,3,0,0,0,3,7
ARUNACHAL PRADESH,SIANG WEST,2012,2,4,0,6,0,7,19
ARUNACHAL PRADESH,SUBANSIRI LOWER,2012,0,2,0,5,0,2,9
ARUNACHAL PRADESH,SUBANSIRI UPPER,2012,4,4,0,11,0,0,19
ARUNACHAL PRADESH,TAWANG,2012,0,0,0,1,0,0,1
ARUNACHAL PRADESH,TIRAP,2012,1,6,0,2,0,0,9
ARUNACHAL PRADESH,UPPER DIBANG VALLEY,2012,0,0,0,1,0,0,1
ARUNACHAL PRADESH,TOTAL,2012,46,58,1,67,2,26,200
ASSAM,BAKSA,2012,33,50,3,4,0,15,105
ASSAM,BARPETA,2012,98,224,5,67,0,638,1032
ASSAM,BIEO,2012,0,0,0,0,0,0,0
ASSAM,BONGAIGAON,2012,50,59,6,15,0,169,299
ASSAM,C.I.D.,2012,4,1,0,0,0,0,5
ASSAM,CACHAR,2012,94,163,19,11,0,551,838
ASSAM,CHIRANG,2012,24,30,0,11,0,78,143
ASSAM,DARRANG,2012,88,168,9,246,0,387,898
ASSAM,DHEMAJI,2012,74,61,2,17,0,82,236
ASSAM,DHUBRI,2012,159,305,13,218,1,729,1425
ASSAM,DIBRUGARH,2012,50,75,0,138,0,316,579
ASSAM,G.R.P.,2012,3,3,2,3,1,10,22
ASSAM,GOALPARA,2012,65,68,3,97,0,323,556
ASSAM,GOLAGHAT,2012,60,154,1,72,0,226,513
ASSAM,GUWAHATI CITY,2012,78,326,9,90,0,237,740
ASSAM,HAILAKANDI,2012,56,65,6,52,0,125,304
ASSAM,HAMREN,2012,3,12,0,2,0,3,20
ASSAM,JORHAT,2012,42,95,1,53,0,254,445
ASSAM,KAMRUP,2012,54,107,5,70,0,172,408
ASSAM,KARBI ANGLONG,2012,28,50,0,4,0,30,112
ASSAM,KARIMGANJ,2012,32,85,11,4,0,262,394
ASSAM,KOKRAJHAR,2012,27,65,3,31,0,84,210
ASSAM,LAKHIMPUR,2012,62,97,0,25,0,19,203
ASSAM,MORIGAON,2012,58,88,4,25,0,115,290
ASSAM,N.C.HILLS,2012,5,13,0,0,0,0,18
ASSAM,NAGAON,2012,173,348,10,245,3,875,1654
ASSAM,NALBARI,2012,34,89,3,83,0,131,340
ASSAM,R.P.O.,2012,0,6,0,0,0,0,6
ASSAM,SIBSAGAR,2012,78,153,5,134,0,269,639
ASSAM,SONITPUR,2012,97,220,11,39,0,124,491
ASSAM,TINSUKIA,2012,64,142,1,43,0,137,387
ASSAM,UDALGURI,2012,23,38,8,41,0,46,156
ASSAM,TOTAL,2012,1716,3360,140,1840,5,6407,13468
BIHAR,ARARIA,2012,53,78,21,8,7,32,199
BIHAR,ARWAL,2012,5,24,13,0,0,22,64
BIHAR,AURANGABAD,2012,22,58,27,2,0,110,219
BIHAR,BAGAHA,2012,11,69,9,0,0,37,126
BIHAR,BANKA,2012,17,45,17,0,0,37,116
BIHAR,BEGUSARAI,2012,11,113,27,0,0,79,230
BIHAR,BETTIAH,2012,35,141,28,0,0,20,224
BIHAR,BHABHUA,2012,10,38,21,0,0,42,111
BIHAR,BHAGALPUR,2012,31,106,24,0,4,119,284
BIHAR,BHOJPUR,2012,9,69,38,0,0,56,172
BIHAR,BUXAR,2012,21,70,28,29,0,86,234
BIHAR,DARBHANGA,2012,44,150,34,0,1,377,606
BIHAR,GAYA,2012,35,120,53,0,0,92,300
BIHAR,GOPALGANJ,2012,20,89,43,0,0,190,342
BIHAR,JAMALPUR RLY.,2012,1,0,0,0,0,0,1
BIHAR,JAMUI,2012,27,43,18,2,0,65,155
BIHAR,JEHANABAD,2012,8,41,24,0,0,37,110
BIHAR,KATIHAR,2012,73,112,24,1,1,111,322
BIHAR,KATIHAR RLY.,2012,0,6,0,1,0,1,8
BIHAR,KHAGARIA,2012,18,34,12,0,0,41,105
BIHAR,KISHANGANJ,2012,32,71,19,0,0,50,172
BIHAR,LAKHISARAI,2012,13,28,10,3,0,55,109
BIHAR,MADHEPURA,2012,31,56,15,0,2,46,150
BIHAR,MADHUBANI,2012,31,163,27,0,0,195,416
BIHAR,MOTIHARI,2012,22,198,67,0,16,156,459
BIHAR,MUNGER,2012,9,49,8,1,0,40,107
BIHAR,MUZAFFARPUR,2012,34,220,83,0,0,80,417
BIHAR,MUZAFFARPUR RLY.,2012,2,0,0,0,0,0,2
BIHAR,NALANDA,2012,11,85,79,7,1,116,299
BIHAR,NAUGACHIA,2012,2,18,10,0,0,64,94
BIHAR,NAWADAH,2012,18,57,29,0,0,13,117
BIHAR,PATNA,2012,49,300,97,19,1,377,843
BIHAR,PATNA RLY.,2012,2,5,3,16,0,2,28
BIHAR,PURNEA,2012,39,95,17,8,4,0,163
BIHAR,ROHTAS,2012,26,94,44,15,0,92,271
BIHAR,SAHARSA,2012,16,76,10,0,0,72,174
BIHAR,SAMASTIPUR,2012,24,112,34,0,0,114,284
BIHAR,SARAN,2012,23,137,74,0,0,138,372
BIHAR,SHEIKHPURA,2012,10,27,8,0,0,37,82
BIHAR,SHEOHAR,2012,2,22,9,3,0,9,45
BIHAR,SITAMARHI,2012,20,143,30,0,0,100,293
BIHAR,SIWAN,2012,20,166,64,2,0,101,353
BIHAR,SUPAUL,2012,20,90,15,0,0,79,204
BIHAR,VAISHALI,2012,20,171,62,1,0,196,450
BIHAR,TOTAL,2012,927,3789,1275,118,37,3686,9832
CHHATTISGARH,BALOD,2012,22,6,4,50,1,9,92
CHHATTISGARH,BALODA BAZAR,2012,45,18,0,98,10,37,208
CHHATTISGARH,BALRAMPUR,2012,64,0,0,52,2,30,148
CHHATTISGARH,BEMETARA,2012,24,18,3,61,5,29,140
CHHATTISGARH,BILASPUR,2012,47,28,10,169,11,95,360
CHHATTISGARH,BIZAPUR,2012,4,3,0,5,0,1,13
CHHATTISGARH,DANTEWARA,2012,7,1,0,4,0,5,17
CHHATTISGARH,DHAMTARI,2012,21,2,1,36,11,15,86
CHHATTISGARH,DURG,2012,91,47,9,178,25,111,461
CHHATTISGARH,GARIYABAND,2012,19,2,1,28,5,6,61
CHHATTISGARH,GRP RAIPUR,2012,2,6,0,5,0,2,15
CHHATTISGARH,JAGDALPUR,2012,36,10,0,20,0,8,74
CHHATTISGARH,JANJGIR,2012,33,19,11,104,13,123,303
CHHATTISGARH,JASHPUR,2012,80,19,2,29,0,31,161
CHHATTISGARH,KABIRDHAM,2012,22,14,1,58,2,20,117
CHHATTISGARH,KANKER,2012,23,6,2,18,1,19,69
CHHATTISGARH,KONDAGAON,2012,11,0,0,4,3,2,20
CHHATTISGARH,KORBA,2012,43,15,4,59,7,42,170
CHHATTISGARH,KORIYA,2012,42,12,5,86,2,65,212
CHHATTISGARH,MAHASAMUND,2012,28,37,4,63,4,33,169
CHHATTISGARH,MUNGELI,2012,6,13,2,24,3,26,74
CHHATTISGARH,NARAYANPUR,2012,5,1,0,4,2,0,12
CHHATTISGARH,RAIGARH,2012,69,14,6,81,8,55,233
CHHATTISGARH,RAIPUR,2012,111,14,8,148,38,109,428
CHHATTISGARH,RAJNANDGAON,2012,31,7,3,52,7,17,117
CHHATTISGARH,SARGUJA,2012,73,18,0,89,1,25,206
CHHATTISGARH,SUKMA,2012,1,5,0,2,0,2,10
CHHATTISGARH,SURAJPUR,2012,74,15,5,74,1,63,232
CHHATTISGARH,TOTAL,2012,1034,350,81,1601,162,980,4208
GOA,NORTH GOA,2012,26,10,0,29,14,11,90
GOA,SOUTH GOA,2012,29,6,0,20,2,13,70
GOA,TOTAL,2012,55,16,0,49,16,24,160
GUJARAT,AHMEDABAD COMMR.,2012,63,183,11,79,7,1448,1791
GUJARAT,AHMEDABAD RURAL,2012,5,67,0,33,0,163,268
GUJARAT,AHWA-DANG,2012,1,1,0,1,1,8,12
GUJARAT,AMRELI,2012,10,75,0,20,7,146,258
GUJARAT,ANAND,2012,9,53,0,22,1,188,273
GUJARAT,BHARUCH,2012,12,22,0,19,1,0,54
GUJARAT,BHAVNAGAR,2012,13,96,0,30,42,221,402
GUJARAT,CID CRIME,2012,1,0,0,0,0,0,1
GUJARAT,DAHOD,2012,10,67,0,17,0,7,101
GUJARAT,GANDHINAGAR,2012,20,26,0,10,1,159,216
GUJARAT,HIMATNAGAR,2012,10,55,0,22,4,249,340
GUJARAT,JAMNAGAR,2012,22,37,0,40,4,439,542
GUJARAT,JUNAGADH,2012,15,53,1,37,5,411,522
GUJARAT,KHEDA NORTH,2012,18,55,0,22,0,161,256
GUJARAT,KUTCH (EAST(G)),2012,17,23,1,12,0,188,241
GUJARAT,KUTCH (WEST-BHUJ),2012,8,17,0,18,0,127,170
GUJARAT,MEHSANA,2012,10,54,0,28,1,245,338
GUJARAT,NARMADA,2012,7,5,0,3,0,13,28
GUJARAT,NAVSARI,2012,4,15,0,4,0,114,137
GUJARAT,PALANPUR,2012,49,107,0,64,1,349,570
GUJARAT,PANCHMAHAL,2012,5,73,0,36,0,294,408
GUJARAT,PATAN,2012,7,31,0,32,1,151,222
GUJARAT,PORBANDAR,2012,10,7,1,8,0,73,99
GUJARAT,RAJKOT COMMR.,2012,11,50,0,10,3,264,338
GUJARAT,RAJKOT RURAL,2012,20,58,3,26,3,292,402
GUJARAT,SURAT COMMR.,2012,40,66,3,28,0,299,436
GUJARAT,SURAT RURAL,2012,13,30,1,14,2,94,154
GUJARAT,SURENDRANAGAR,2012,19,46,0,51,5,124,245
GUJARAT,TAPI,2012,5,3,0,9,0,17,34
GUJARAT,VADODARA COMMR.,2012,11,57,0,15,4,306,393
GUJARAT,VADODARA RURAL,2012,15,72,0,23,0,90,200
GUJARAT,VALSAD,2012,12,19,0,9,0,15,55
GUJARAT,W.RLY AHMEDABAD,2012,1,2,0,2,0,2,7
GUJARAT,W.RLY VADODARA,2012,0,2,0,1,0,1,4
GUJARAT,TOTAL,2012,473,1527,21,745,93,6658,9517
HARYANA,AMBALA RURAL,2012,11,19,7,12,4,73,126
HARYANA,AMBALA URBAN,2012,21,39,5,23,14,159,261
HARYANA,BHIWANI,2012,28,69,19,45,23,179,363
HARYANA,FARIDABAD,2012,47,87,8,31,84,197,454
HARYANA,FATEHABAD,2012,15,33,4,7,7,125,191
HARYANA,GRP,2012,1,7,5,9,83,1,106
HARYANA,GURGAON,2012,44,47,15,18,31,150,305
HARYANA,HISSAR,2012,44,88,12,39,23,312,518
HARYANA,JHAJJAR,2012,20,17,10,19,14,135,215
HARYANA,JIND,2012,34,40,17,27,0,114,232
HARYANA,KAITHAL,2012,18,20,6,15,0,127,186
HARYANA,KARNAL,2012,63,41,23,50,28,204,409
HARYANA,KURUKSHETRA,2012,25,30,11,20,27,110,223
HARYANA,MAHENDRAGARH,2012,14,18,10,26,0,78,146
HARYANA,MEWAT,2012,50,15,5,15,7,168,260
HARYANA,PALWAL,2012,32,47,12,27,0,107,225
HARYANA,PANCHKULA,2012,18,23,7,13,1,51,113
HARYANA,PANIPAT,2012,35,67,15,23,12,136,288
HARYANA,REWARI,2012,24,20,12,16,1,102,175
HARYANA,ROHTAK,2012,37,23,12,24,40,143,279
HARYANA,SIRSA,2012,30,55,6,25,1,159,276
HARYANA,SONIPAT,2012,32,49,30,26,25,185,347
HARYANA,YAMUNANAGAR,2012,25,46,7,15,9,122,224
HARYANA,TOTAL,2012,668,900,258,525,434,3137,5922
HIMACHAL PRADESH,BADDIPOLICEDIST,2012,12,8,1,7,0,16,44
HIMACHAL PRADESH,BILASPUR,2012,12,5,0,21,12,22,72
HIMACHAL PRADESH,CHAMBA,2012,10,14,1,9,4,7,45
HIMACHAL PRADESH,CID,2012,0,0,0,0,0,0,0
HIMACHAL PRADESH,G.R.P.,2012,0,0,0,0,0,0,0
HIMACHAL PRADESH,HAMIRPUR,2012,8,2,0,20,5,17,52
HIMACHAL PRADESH,KANGRA,2012,26,47,0,45,13,43,174
HIMACHAL PRADESH,KINNAUR,2012,6,2,0,1,0,5,14
HIMACHAL PRADESH,KULLU,2012,22,5,0,22,0,10,59
HIMACHAL PRADESH,LAHAUL-SPITI,2012,2,0,0,1,0,0,3
HIMACHAL PRADESH,MANDI,2012,28,18,0,49,17,32,144
HIMACHAL PRADESH,SHIMLA,2012,23,25,0,28,7,23,106
HIMACHAL PRADESH,SIRMAUR,2012,17,11,0,24,4,18,74
HIMACHAL PRADESH,SOLAN,2012,9,8,0,13,1,16,47
HIMACHAL PRADESH,UNA,2012,8,7,0,10,5,42,72
HIMACHAL PRADESH,TOTAL,2012,183,152,2,250,68,251,906
JAMMU & KASHMIR,ANANTNAG,2012,14,92,0,130,33,4,273
JAMMU & KASHMIR,AWANTIPORA,2012,4,29,0,11,7,1,52
JAMMU & KASHMIR,BANDIPORA,2012,6,45,0,81,5,0,137
JAMMU & KASHMIR,BARAMULLA,2012,12,79,0,109,23,13,236
JAMMU & KASHMIR,BUDGAM,2012,7,73,0,114,15,5,214
JAMMU & KASHMIR,CRIME JAMMU,2012,0,0,0,0,0,0,0
JAMMU & KASHMIR,CRIME SRINAGAR,2012,0,0,0,0,0,0,0
JAMMU & KASHMIR,DODA,2012,16,31,0,23,5,26,101
JAMMU & KASHMIR,GANDERBAL,2012,9,32,0,97,3,2,143
JAMMU & KASHMIR,HANDWARA,2012,6,35,0,88,3,2,134
JAMMU & KASHMIR,JAMMU,2012,39,92,5,44,33,67,280
JAMMU & KASHMIR,KARGIL,2012,1,0,0,1,0,0,2
JAMMU & KASHMIR,KATHUA,2012,20,34,1,30,12,14,111
JAMMU & KASHMIR,KISHTWAR,2012,6,23,0,12,1,11,53
JAMMU & KASHMIR,KULGAM,2012,15,68,0,96,19,2,200
JAMMU & KASHMIR,KUPWARA,2012,15,49,0,53,16,9,142
JAMMU & KASHMIR,LEH,2012,3,1,0,5,0,0,9
JAMMU & KASHMIR,POONCH,2012,9,41,0,31,6,14,101
JAMMU & KASHMIR,PULWAMA,2012,3,21,0,8,19,0,51
JAMMU & KASHMIR,RAILWAYS JAMMU,2012,0,0,0,0,1,0,1
JAMMU & KASHMIR,RAILWAYS KASHMIR,2012,0,1,0,0,0,0,1
JAMMU & KASHMIR,RAILWAYS KATRA,2012,0,0,0,0,0,0,0
JAMMU & KASHMIR,RAJOURI,2012,32,54,1,51,11,44,193
JAMMU & KASHMIR,RAMBAN,2012,7,22,0,9,6,0,44
JAMMU & KASHMIR,REASI,2012,12,18,0,14,6,2,52
JAMMU & KASHMIR,SAMBA,2012,8,9,1,10,11,4,43
JAMMU & KASHMIR,SHOPIAN,2012,3,47,0,29,9,0,88
JAMMU & KASHMIR,SOPORE,2012,7,34,0,55,9,6,111
JAMMU & KASHMIR,SRINAGAR,2012,19,89,0,201,82,63,454
JAMMU & KASHMIR,UDHAMPUR,2012,30,22,0,20,12,12,96
JAMMU & KASHMIR,TOTAL,2012,303,1041,8,1322,347,301,3322
JHARKHAND,BOKARO,2012,46,63,21,4,0,212,346
JHARKHAND,CHAIBASA,2012,34,15,6,8,0,20,83
JHARKHAND,CHATRA,2012,15,20,8,6,0,18,67
JHARKHAND,DEOGHAR,2012,38,3,18,35,0,159,253
JHARKHAND,DHANBAD,2012,41,101,49,4,2,89,286
JHARKHAND,DHANBAD RLY.,2012,2,2,1,8,0,2,15
JHARKHAND,DUMKA,2012,29,26,8,12,0,43,118
JHARKHAND,GARHWA,2012,43,21,21,14,0,68,167
JHARKHAND,GIRIDIH,2012,37,36,32,46,0,104,255
JHARKHAND,GODDA,2012,22,42,11,2,0,0,77
JHARKHAND,GUMLA,2012,36,44,2,9,0,6,97
JHARKHAND,HAZARIBAGH,2012,42,49,24,9,0,54,178
JHARKHAND,JAMSHEDPUR,2012,56,91,17,22,3,106,295
JHARKHAND,JAMSHEDPUR RLY.,2012,1,1,0,0,0,0,2
JHARKHAND,JAMTARA,2012,27,10,5,1,0,72,115
JHARKHAND,KHUNTI,2012,8,10,1,2,1,0,22
JHARKHAND,KODERMA,2012,8,22,13,12,0,29,84
JHARKHAND,LATEHAR,2012,15,16,4,6,0,10,51
JHARKHAND,LOHARDAGGA,2012,23,18,1,6,0,23,71
JHARKHAND,PAKUR,2012,53,18,1,10,0,64,146
JHARKHAND,PALAMU,2012,26,30,28,10,0,20,114
JHARKHAND,RAMGARH,2012,26,19,7,10,2,7,71
JHARKHAND,RANCHI,2012,52,53,11,22,1,45,184
JHARKHAND,SAHEBGANJ,2012,65,45,6,11,1,74,202
JHARKHAND,SARAIKELA,2012,35,14,6,10,0,25,90
JHARKHAND,SIMDEGA,2012,32,17,1,5,0,11,66
JHARKHAND,TOTAL,2012,812,786,302,284,10,1261,3455
KARNATAKA,BAGALKOT,2012,11,14,6,63,0,72,166
KARNATAKA,BANGALORE COMMR.,2012,90,433,51,321,51,524,1470
KARNATAKA,BANGALORE RURAL,2012,31,41,10,70,0,96,248
KARNATAKA,BELGAUM,2012,37,34,5,205,9,307,597
KARNATAKA,BELLARY,2012,18,24,9,48,0,104,203
KARNATAKA,BIDAR,2012,11,24,10,40,2,99,186
KARNATAKA,BIJAPUR,2012,18,24,4,41,0,128,215
KARNATAKA,CBPURA,2012,12,20,12,56,3,36,139
KARNATAKA,CHAMARAJNAGAR,2012,9,8,2,64,0,62,145
KARNATAKA,CHICKMAGALUR,2012,11,7,4,70,2,89,183
KARNATAKA,CHITRADURGA,2012,26,34,6,140,0,75,281
KARNATAKA,DAKSHIN KANNADA,2012,12,9,2,35,8,42,108
KARNATAKA,DAVANAGERE,2012,17,20,8,117,0,119,281
KARNATAKA,DHARWAD COMMR.,2012,6,42,2,16,0,65,131
KARNATAKA,DHARWAD RURAL,2012,5,3,0,38,0,24,70
KARNATAKA,GADAG,2012,6,12,2,59,0,47,126
KARNATAKA,GULBARGA,2012,29,39,10,132,0,151,361
KARNATAKA,HASSAN,2012,21,19,5,120,1,155,321
KARNATAKA,HAVERI,2012,12,0,3,72,0,68,155
KARNATAKA,K.G.F.,2012,10,0,2,10,0,19,41
KARNATAKA,KODAGU,2012,12,3,2,25,0,43,85
KARNATAKA,KOLAR,2012,18,14,1,37,0,34,104
KARNATAKA,KOPPAL,2012,7,0,0,17,0,87,111
KARNATAKA,MANDYA,2012,35,39,9,149,1,204,437
KARNATAKA,MANGALORE CITY,2012,12,4,1,29,1,48,95
KARNATAKA,MYSORE COMMR.,2012,12,10,6,22,0,32,82
KARNATAKA,MYSORE RURAL,2012,28,47,1,163,0,158,397
KARNATAKA,RAICHUR,2012,19,25,1,141,0,190,376
KARNATAKA,RAILWAYS,2012,2,1,2,2,1,0,8
KARNATAKA,RAMANAGAR,2012,16,53,17,112,0,73,271
KARNATAKA,SHIMOGA,2012,14,24,6,158,3,222,427
KARNATAKA,TUMKUR,2012,33,10,18,171,0,132,364
KARNATAKA,UDUPI,2012,5,3,0,41,1,38,88
KARNATAKA,UTTAR KANNADA,2012,7,10,1,97,8,78,201
KARNATAKA,YADGIRI,2012,9,20,0,97,9,63,198
KARNATAKA,TOTAL,2012,621,1070,218,2978,100,3684,8671
KERALA,ALAPUZHA,2012,44,15,1,250,14,294,618
KERALA,ERNAKULAM COMMR.,2012,28,5,0,108,16,127,284
KERALA,ERNAKULAM RURAL,2012,59,9,0,162,25,216,471
KERALA,IDUKKI,2012,53,10,2,189,10,219,483
KERALA,KANNUR,2012,66,18,0,183,12,391,670
KERALA,KASARGOD,2012,89,10,3,156,15,205,478
KERALA,KOLLAM COMMR.,2012,46,18,4,171,41,336,616
KERALA,KOLLAM RURAL,2012,49,14,1,270,20,326,680
KERALA,KOTTAYAM,2012,55,17,1,265,55,255,648
KERALA,KOZHIKODE COMMR.,2012,36,3,0,103,83,144,369
KERALA,KOZHIKODE RURAL,2012,42,13,0,153,15,313,536
KERALA,MALAPPURAM,2012,97,3,2,221,21,668,1012
KERALA,PALAKKAD,2012,68,9,5,146,11,401,640
KERALA,PATHANAMTHITTA,2012,32,16,2,137,8,162,357
KERALA,RAILWAYS,2012,0,1,0,46,12,0,59
KERALA,THRISSUR COMMR.,2012,35,9,0,111,32,146,333
KERALA,THRISSUR RURAL,2012,46,9,2,218,36,361,672
KERALA,TRIVANDRUM COMMR.,2012,41,16,0,226,19,159,461
KERALA,TRIVANDRUM RURAL,2012,97,10,8,541,38,398,1092
KERALA,WAYANADU,2012,36,9,1,79,15,95,235
KERALA,TOTAL,2012,1019,214,32,3735,498,5216,10714
MADHYA PRADESH,ALIRAJPUR,2012,22,12,0,31,1,2,68
MADHYA PRADESH,ANUPPUR,2012,62,8,12,80,6,53,221
MADHYA PRADESH,ASHOK NAGAR,2012,50,5,10,62,1,21,149
MADHYA PRADESH,BALAGHAT,2012,78,7,6,113,11,63,278
MADHYA PRADESH,BARWANI,2012,50,8,2,72,5,13,150
MADHYA PRADESH,BETUL,2012,118,10,11,151,15,57,362
MADHYA PRADESH,BHIND,2012,49,25,40,83,7,50,254
MADHYA PRADESH,BHOPAL,2012,143,49,19,244,52,254,761
MADHYA PRADESH,BHOPAL RLY.,2012,4,1,0,14,1,3,23
MADHYA PRADESH,BURHANPUR,2012,23,5,2,42,22,47,141
MADHYA PRADESH,CHHATARPUR,2012,62,39,26,172,0,68,367
MADHYA PRADESH,CHHINDWARA,2012,122,19,18,202,41,108,510
MADHYA PRADESH,DAMOH,2012,50,27,20,165,0,108,370
MADHYA PRADESH,DATIYA,2012,23,20,8,61,0,25,137
MADHYA PRADESH,DEWAS,2012,70,29,19,146,31,130,425
MADHYA PRADESH,DHAR,2012,81,45,39,173,16,69,423
MADHYA PRADESH,DINDORI,2012,40,6,5,80,6,39,176
MADHYA PRADESH,GUNA,2012,60,25,8,131,11,34,269
MADHYA PRADESH,GWALIOR,2012,85,75,35,158,13,202,568
MADHYA PRADESH,HARDA,2012,26,10,7,51,4,16,114
MADHYA PRADESH,HOSHANGABAD,2012,69,27,12,129,21,57,315
MADHYA PRADESH,INDORE,2012,173,42,24,405,114,448,1206
MADHYA PRADESH,INDORE RLY.,2012,3,3,0,3,1,0,10
MADHYA PRADESH,JABALPUR,2012,127,45,33,253,43,219,720
MADHYA PRADESH,JABALPUR RLY.,2012,3,0,0,13,1,0,17
MADHYA PRADESH,JHABUA,2012,62,17,0,92,0,24,195
MADHYA PRADESH,KATNI,2012,58,14,12,146,14,46,290
MADHYA PRADESH,KHANDWA,2012,66,5,6,136,6,34,253
MADHYA PRADESH,KHARGON,2012,67,20,30,133,22,45,317
MADHYA PRADESH,MANDLA,2012,75,8,3,94,12,40,232
MADHYA PRADESH,MANDSAUR,2012,49,28,6,100,6,78,267
MADHYA PRADESH,MORENA,2012,32,29,29,107,3,94,294
MADHYA PRADESH,NARSINGHPUR,2012,71,14,16,158,31,79,369
MADHYA PRADESH,NEEMUCH,2012,25,10,4,43,13,42,137
MADHYA PRADESH,PANNA,2012,34,4,18,72,10,31,169
MADHYA PRADESH,RAISEN,2012,92,16,22,158,0,72,360
MADHYA PRADESH,RAJGARH,2012,90,47,6,181,25,50,399
MADHYA PRADESH,RATLAM,2012,72,25,13,128,11,85,334
MADHYA PRADESH,REWA,2012,92,35,39,115,7,101,389
MADHYA PRADESH,SAGAR,2012,125,61,34,441,22,145,828
MADHYA PRADESH,SATNA,2012,89,25,17,138,7,121,397
MADHYA PRADESH,SEONI,2012,65,8,11,100,7,24,215
MADHYA PRADESH,SHAHDOL,2012,81,27,13,133,7,141,402
MADHYA PRADESH,SHAJAPUR,2012,67,17,7,102,15,42,250
MADHYA PRADESH,SHEOPUR,2012,17,4,5,40,0,29,95
MADHYA PRADESH,SHIVPURI,2012,104,22,9,148,19,67,369
MADHYA PRADESH,SIDHI,2012,48,38,18,84,5,59,252
MADHYA PRADESH,SIHORE,2012,69,14,10,100,13,47,253
MADHYA PRADESH,SINGRAULI,2012,32,33,13,87,6,63,234
MADHYA PRADESH,TIKAMGARH,2012,61,8,16,124,7,27,243
MADHYA PRADESH,UJJAIN,2012,73,31,11,180,53,202,550
MADHYA PRADESH,UMARIYA,2012,22,2,0,68,7,17,116
MADHYA PRADESH,VIDISHA,2012,94,23,19,213,23,97,469
MADHYA PRADESH,TOTAL,2012,3425,1127,743,6655,774,3988,16712
MAHARASHTRA,AHMEDNAGAR,2012,61,49,23,147,1,576,857
MAHARASHTRA,AKOLA,2012,19,19,4,92,40,87,261
MAHARASHTRA,AMRAVATI COMMR.,2012,20,16,1,53,14,74,178
MAHARASHTRA,AMRAVATI RURAL,2012,64,17,3,154,42,139,419
MAHARASHTRA,AURANGABAD COMMR.,2012,23,18,4,79,28,120,272
MAHARASHTRA,AURANGABAD RURAL,2012,25,10,18,77,25,298,453
MAHARASHTRA,BEED,2012,42,21,8,81,9,378,539
MAHARASHTRA,BHANDARA,2012,26,8,3,36,33,59,165
MAHARASHTRA,BULDHANA,2012,29,28,27,107,35,193,419
MAHARASHTRA,CHANDRAPUR,2012,44,29,4,119,79,125,400
MAHARASHTRA,DHULE,2012,30,14,4,39,2,207,296
MAHARASHTRA,GADCHIROLI,2012,18,6,0,30,5,12,71
MAHARASHTRA,GONDIA,2012,38,10,0,47,18,42,155
MAHARASHTRA,HINGOLI,2012,13,5,6,33,3,88,148
MAHARASHTRA,JALGAON,2012,45,39,1,134,51,409,679
MAHARASHTRA,JALNA,2012,25,18,36,89,9,303,480
MAHARASHTRA,KOLHAPUR,2012,48,22,17,66,32,148,333
MAHARASHTRA,LATUR,2012,21,32,4,61,0,212,330
MAHARASHTRA,MUMBAI COMMR.,2012,232,141,11,614,235,388,1621
MAHARASHTRA,MUMBAI RLY.,2012,1,5,1,21,3,0,31
MAHARASHTRA,NAGPUR COMMR.,2012,57,39,6,84,53,166,405
MAHARASHTRA,NAGPUR RLY.,2012,1,2,0,4,4,3,14
MAHARASHTRA,NAGPUR RURAL,2012,29,15,7,82,20,76,229
MAHARASHTRA,NANDED,2012,48,32,25,71,5,421,602
MAHARASHTRA,NANDURBAR,2012,19,8,0,22,4,78,131
MAHARASHTRA,NASIK COMMR.,2012,20,13,3,36,16,147,235
MAHARASHTRA,NASIK RURAL,2012,46,20,17,98,26,319,526
MAHARASHTRA,NAVI MUMBAI,2012,36,11,3,64,25,91,230
MAHARASHTRA,OSMANABAD,2012,38,21,2,86,12,175,334
MAHARASHTRA,PARBHANI,2012,28,13,3,68,9,242,363
MAHARASHTRA,PUNE COMMR.,2012,85,77,9,120,85,215,591
MAHARASHTRA,PUNE RLY.,2012,2,1,0,3,0,0,6
MAHARASHTRA,PUNE RURAL,2012,92,51,12,128,59,221,563
MAHARASHTRA,RAIGAD,2012,21,3,19,37,9,40,129
MAHARASHTRA,RATNAGIRI,2012,11,3,2,31,17,38,102
MAHARASHTRA,SANGLI,2012,33,23,8,57,15,64,200
MAHARASHTRA,SATARA,2012,43,25,0,78,29,166,341
MAHARASHTRA,SINDHUDURG,2012,9,5,0,20,17,11,62
MAHARASHTRA,SOLAPUR COMMR.,2012,25,21,1,31,10,53,141
MAHARASHTRA,SOLAPUR RURAL,2012,67,24,3,58,40,151,343
MAHARASHTRA,THANE COMMR.,2012,107,77,4,203,28,330,749
MAHARASHTRA,THANE RURAL,2012,63,37,6,155,32,111,404
MAHARASHTRA,WARDHA,2012,40,25,0,93,30,59,247
MAHARASHTRA,WASHIM,2012,31,27,6,84,19,133,300
MAHARASHTRA,YAVATMAL,2012,64,60,18,143,66,247,598
MAHARASHTRA,TOTAL,2012,1839,1140,329,3935,1294,7415,15952
MANIPUR,BISHNUPUR,2012,11,7,0,3,0,4,25
MANIPUR,CHANDEL,2012,0,1,0,1,0,0,2
MANIPUR,CHURACHANDPUR,2012,1,1,0,1,0,1,4
MANIPUR,CID,2012,0,0,0,0,0,0,0
MANIPUR,IMPHAL EAST,2012,10,36,0,10,0,11,67
MANIPUR,IMPHAL WEST,2012,18,47,0,21,0,9,95
MANIPUR,SENAPATI,2012,2,3,0,1,0,0,6
MANIPUR,TAMENGLONG,2012,1,1,0,0,0,0,2
MANIPUR,THOUBAL,2012,20,37,0,12,1,17,87
MANIPUR,UKHRUL,2012,0,0,0,0,0,1,1
MANIPUR,TOTAL,2012,63,133,0,49,1,43,289
MEGHALAYA,GARO HILLS EAST,2012,2,1,0,3,0,0,6
MEGHALAYA,GARO HILLS SOUTH,2012,6,2,0,2,0,1,11
MEGHALAYA,GARO HILLS WEST,2012,6,7,0,2,0,0,15
MEGHALAYA,JAINTIA HILLS,2012,32,5,0,3,0,0,40
MEGHALAYA,KHASI HILLS EAST,2012,58,5,1,21,0,13,98
MEGHALAYA,KHASI HILLS WEST,2012,28,0,0,8,0,0,36
MEGHALAYA,RI-BHOI,2012,32,4,0,4,0,2,42
MEGHALAYA,TOTAL,2012,164,24,1,43,0,16,248
MIZORAM,AIZAWL,2012,42,0,0,44,0,8,94
MIZORAM,CHAMPHAI,2012,12,1,0,15,0,0,28
MIZORAM,KOLASIB,2012,9,0,0,9,0,0,18
MIZORAM,LAWNGTLAI,2012,7,1,0,0,0,0,8
MIZORAM,LUNGLEI,2012,16,0,0,4,0,0,20
MIZORAM,MAMIT,2012,10,0,0,3,0,0,13
MIZORAM,SAIHA,2012,0,1,0,1,0,0,2
MIZORAM,SERCHHIP,2012,7,0,0,9,0,0,16
MIZORAM,TOTAL,2012,103,3,0,85,0,8,199
NAGALAND,DIMAPUR,2012,9,5,0,9,0,0,23
NAGALAND,KIPHIRE,2012,0,0,0,0,0,0,0
NAGALAND,KOHIMA,2012,1,0,0,2,0,0,3
NAGALAND,LONGLENG,2012,0,0,0,0,0,0,0
NAGALAND,MOKOKCHUNG,2012,3,0,0,3,0,0,6
NAGALAND,MON,2012,3,2,0,0,0,0,5
NAGALAND,PEREN,2012,0,0,0,0,0,0,0
NAGALAND,PHEK,2012,1,0,0,2,0,0,3
NAGALAND,TUENSANG,2012,1,0,0,0,0,0,1
NAGALAND,WOKHA,2012,2,0,0,0,0,0,2
NAGALAND,ZUNHEBOTO,2012,1,3,0,0,0,0,4
NAGALAND,TOTAL,2012,21,10,0,16,0,0,47
ODISHA,ANGUL,2012,63,55,20,321,8,76,543
ODISHA,BALASORE,2012,87,130,43,242,20,307,829
ODISHA,BARAGARH,2012,35,30,3,154,14,96,332
ODISHA,BERHAMPUR,2012,18,17,10,158,12,119,334
ODISHA,BHADRAK,2012,54,66,20,93,12,155,400
ODISHA,BOLANGIR,2012,51,36,7,238,15,40,387
ODISHA,BOUDH,2012,10,8,0,79,6,24,127
ODISHA,CUTTACK,2012,43,57,27,38,7,147,319
ODISHA,DCP BBSR,2012,56,76,24,75,22,91,344
ODISHA,DCP CTC,2012,28,43,14,30,2,134,251
ODISHA,DEOGARH,2012,17,5,2,41,0,9,74
ODISHA,DHENKANAL,2012,29,35,23,267,18,33,405
ODISHA,GAJAPATI,2012,18,9,2,61,3,8,101
ODISHA,GANJAM,2012,53,55,32,356,27,39,562
ODISHA,JAGATSINGHPUR,2012,43,52,20,43,2,123,283
ODISHA,JAJPUR,2012,49,56,51,83,4,162,405
ODISHA,JHARSUGUDA,2012,21,6,2,41,11,50,131
ODISHA,KALAHANDI,2012,65,41,8,120,14,96,344
ODISHA,KANDHAMAL,2012,32,27,1,101,4,34,199
ODISHA,KENDRAPARA,2012,38,65,48,7,4,43,205
ODISHA,KEONJHAR,2012,102,70,28,231,24,181,636
ODISHA,KHURDA,2012,27,46,16,338,2,178,607
ODISHA,KORAPUT,2012,73,31,21,114,9,0,248
ODISHA,MALKANGIR,2012,17,19,5,51,4,14,110
ODISHA,MAYURBHANJ,2012,86,67,34,295,12,129,623
ODISHA,NAYAGARH,2012,25,35,16,11,1,17,105
ODISHA,NOWRANGPUR,2012,42,45,2,83,14,43,229
ODISHA,NUAPADA,2012,18,17,1,62,6,13,117
ODISHA,PURI,2012,42,51,26,33,3,161,316
ODISHA,RAYAGADA,2012,41,40,4,111,9,29,234
ODISHA,ROURKELA,2012,65,22,2,102,4,29,224
ODISHA,SAMBALPUR,2012,57,26,0,62,4,32,181
ODISHA,SONEPUR,2012,12,8,4,53,1,10,88
ODISHA,SRP(CUTTACK),2012,0,0,0,11,1,0,12
ODISHA,SRP(ROURKELA),2012,1,3,1,9,0,2,16
ODISHA,SUNDARGARH,2012,40,15,8,73,5,14,155
ODISHA,TOTAL,2012,1458,1364,525,4187,304,2638,10476
PUNJAB,AMRITSAR RURAL,2012,18,30,8,12,0,49,117
PUNJAB,BARNALA,2012,25,8,2,4,0,14,53
PUNJAB,BATALA,2012,25,20,4,10,0,19,78
PUNJAB,BHATINDA,2012,44,31,6,19,0,55,155
PUNJAB,CP AMRITSAR,2012,27,45,5,14,0,105,196
PUNJAB,CP JALANDHAR,2012,33,29,6,17,3,107,195
PUNJAB,CP LUDHIANA,2012,69,99,10,30,14,135,357
PUNJAB,FARIDKOT,2012,17,18,2,11,1,20,69
PUNJAB,FATEHGARH SAHIB,2012,15,7,2,3,1,21,49
PUNJAB,FAZILKA,2012,32,26,2,1,0,36,97
PUNJAB,FEROZPUR,2012,15,16,4,4,0,43,82
PUNJAB,G.R.P,2012,0,0,2,0,0,0,2
PUNJAB,GURDASPUR,2012,14,34,10,11,0,45,114
PUNJAB,HOSHIARPUR,2012,33,28,8,14,0,70,153
PUNJAB,JALANDHAR RURAL,2012,29,33,3,34,3,53,155
PUNJAB,KAPURTHALA,2012,16,34,3,8,0,46,107
PUNJAB,KHANNA,2012,14,10,0,3,0,18,45
PUNJAB,LUDHIANA RURAL,2012,11,21,4,5,1,23,65
PUNJAB,MANSA,2012,22,10,3,9,0,23,67
PUNJAB,MOGA,2012,23,10,3,14,0,25,75
PUNJAB,MUKTSAR,2012,18,28,3,10,2,30,91
PUNJAB,PATHANKOT,2012,13,11,7,2,0,25,58
PUNJAB,PATIALA,2012,44,32,4,24,0,86,190
PUNJAB,ROPAR,2012,22,18,0,13,3,15,71
PUNJAB,SANGRUR,2012,34,31,7,24,3,40,139
PUNJAB,SAS NGR,2012,23,33,7,31,0,127,221
PUNJAB,SBS NAGAR,2012,21,13,0,3,0,25,62
PUNJAB,TARN TARAN,2012,23,14,3,10,0,38,88
PUNJAB,TOTAL,2012,680,689,118,340,31,1293,3151
RAJASTHAN,AJMER,2012,70,76,13,72,0,668,899
RAJASTHAN,ALWAR,2012,129,154,47,135,0,655,1120
RAJASTHAN,BANSWARA,2012,56,87,4,49,3,237,436
RAJASTHAN,BARAN,2012,69,84,7,185,2,313,660
RAJASTHAN,BARMER,2012,21,35,20,59,0,237,372
RAJASTHAN,BHARATPUR,2012,108,168,32,79,0,567,954
RAJASTHAN,BHILWARA,2012,59,70,10,98,0,609,846
RAJASTHAN,BIKANER,2012,67,35,16,31,0,546,695
RAJASTHAN,BUNDI,2012,43,77,5,90,1,304,520
RAJASTHAN,CHITTORGARH,2012,59,81,6,64,1,608,819
RAJASTHAN,CHURU,2012,59,26,8,5,0,405,503
RAJASTHAN,DAUSA,2012,14,75,19,9,0,181,298
RAJASTHAN,DHOLPUR,2012,32,60,30,19,0,195,336
RAJASTHAN,DUNGARPUR,2012,32,65,5,48,0,119,269
RAJASTHAN,G.R.P.AJMER,2012,4,5,1,13,0,0,23
RAJASTHAN,G.R.P.JODHPUR,2012,1,0,1,2,0,0,4
RAJASTHAN,GANGANAGAR,2012,77,73,21,58,2,803,1034
RAJASTHAN,HANUMANGARH,2012,92,57,19,43,0,515,726
RAJASTHAN,JAIPUR EAST,2012,41,55,10,24,0,201,331
RAJASTHAN,JAIPUR NORTH,2012,37,54,13,29,0,265,398
RAJASTHAN,JAIPUR RURAL,2012,39,86,11,46,0,281,463
RAJASTHAN,JAIPUR SOUTH,2012,17,21,7,20,0,217,282
RAJASTHAN,JAIPUR WEST,2012,38,60,0,18,0,257,373
RAJASTHAN,JAISALMER,2012,12,5,11,20,0,22,70
RAJASTHAN,JALORE,2012,13,39,15,40,0,138,245
RAJASTHAN,JHALAWAR,2012,81,76,5,205,2,434,803
RAJASTHAN,JHUNJHUNU,2012,45,55,17,44,0,347,508
RAJASTHAN,JODHPUR EAST,2012,20,13,11,16,0,296,356
RAJASTHAN,JODHPUR RURAL,2012,27,28,16,26,0,121,218
RAJASTHAN,JODHPUR WEST,2012,20,23,5,27,0,5,80
RAJASTHAN,KARAULI,2012,44,77,15,7,0,196,339
RAJASTHAN,KOTA CITY,2012,45,62,5,73,0,428,613
RAJASTHAN,KOTA RURAL,2012,42,44,6,105,2,200,399
RAJASTHAN,NAGAUR,2012,53,106,11,66,0,416,652
RAJASTHAN,PALI,2012,61,104,9,75,1,464,714
RAJASTHAN,PRATAPGARH,2012,137,78,2,79,0,276,572
RAJASTHAN,RAJSAMAND,2012,14,53,5,40,1,263,376
RAJASTHAN,SAWAI MADHOPUR,2012,19,75,6,39,0,213,352
RAJASTHAN,SIKAR,2012,55,62,18,22,0,322,479
RAJASTHAN,SIROHI,2012,29,64,4,74,1,180,352
RAJASTHAN,TONK,2012,19,66,3,24,2,309,423
RAJASTHAN,UDAIPUR,2012,149,163,9,174,0,499,994
RAJASTHAN,TOTAL,2012,2049,2697,478,2352,18,13312,20906
SIKKIM,EAST,2012,13,6,1,7,0,2,29
SIKKIM,NORTH,2012,0,0,0,0,0,0,0
SIKKIM,SOUTH,2012,12,3,0,6,0,1,22
SIKKIM,WEST,2012,9,1,0,6,0,1,17
SIKKIM,TOTAL,2012,34,10,1,19,0,4,68
TAMIL NADU,ARIYALUR,2012,11,39,1,53,0,13,117
TAMIL NADU,CHENNAI,2012,94,65,12,90,141,237,639
TAMIL NADU,CHENNAI RLY.,2012,0,2,0,5,0,2,9
TAMIL NADU,COIMBATORE RURAL,2012,9,32,1,38,0,48,128
TAMIL NADU,COIMBATORE URBAN,2012,20,12,0,17,2,112,163
TAMIL NADU,CUDDALORE,2012,40,124,8,64,0,63,299
TAMIL NADU,DHARMAPURI,2012,25,93,1,48,2,66,235
TAMIL NADU,DINDIGUL,2012,16,97,4,34,0,111,262
TAMIL NADU,ERODE,2012,8,23,1,42,0,26,100
TAMIL NADU,KANCHIPURAM,2012,19,17,3,17,1,17,74
TAMIL NADU,KANYAKUMARI,2012,12,33,4,11,0,100,160
TAMIL NADU,KARUR,2012,4,48,1,25,2,11,91
TAMIL NADU,KRISHNAGIRI,2012,14,41,1,51,1,33,141
TAMIL NADU,MADURAI RURAL,2012,30,75,11,75,4,71,266
TAMIL NADU,MADURAI URBAN,2012,11,51,3,28,8,62,163
TAMIL NADU,NAGAPATTINAM,2012,10,40,1,34,36,10,131
TAMIL NADU,NAMAKKAL,2012,12,44,1,39,15,8,119
TAMIL NADU,NILGIRIS,2012,9,7,1,15,2,8,42
TAMIL NADU,PERAMBALUR,2012,3,31,0,22,0,6,62
TAMIL NADU,PUDUKOTTAI,2012,6,28,0,26,1,35,96
TAMIL NADU,RAMNATHAPURAM,2012,9,35,3,15,3,18,83
TAMIL NADU,SALEM RURAL,2012,36,75,1,87,0,35,234
TAMIL NADU,SALEM URBAN,2012,15,18,3,12,14,21,83
TAMIL NADU,SIVAGANGAI,2012,11,39,3,37,0,57,147
TAMIL NADU,THANJAVUR,2012,14,43,1,76,0,28,162
TAMIL NADU,THENI,2012,22,40,5,50,0,63,180
TAMIL NADU,THIRUNELVELI RURAL,2012,44,43,3,58,0,266,414
TAMIL NADU,THIRUNELVELI URBAN,2012,3,3,2,6,0,25,39
TAMIL NADU,THIRUVALLUR,2012,18,12,5,8,1,19,63
TAMIL NADU,THIRUVANNAMALAI,2012,21,52,1,8,0,37,119
TAMIL NADU,THIRUVARUR,2012,11,33,1,6,0,16,67
TAMIL NADU,THOOTHUGUDI,2012,26,35,1,1,0,50,113
TAMIL NADU,TIRUPPUR,2012,8,38,7,52,0,76,181
TAMIL NADU,TRICHY RLY.,2012,0,1,0,2,0,1,4
TAMIL NADU,TRICHY RURAL,2012,14,23,3,33,0,24,97
TAMIL NADU,TRICHY URBAN,2012,7,13,3,9,39,24,95
TAMIL NADU,VELLORE,2012,24,68,8,38,0,61,199
TAMIL NADU,VILLUPURAM,2012,78,188,4,239,0,58,567
TAMIL NADU,VIRUDHUNAGAR,2012,23,32,2,23,110,47,237
TAMIL NADU,TOTAL,2012,737,1693,110,1494,382,1965,6381
TRIPURA,DHALAI,2012,35,8,5,30,0,56,134
TRIPURA,GOMATI,2012,26,14,4,34,0,157,235
TRIPURA,GRP,2012,0,0,0,0,0,0,0
TRIPURA,KHOWAI,2012,10,3,3,22,0,36,74
TRIPURA,NORTH,2012,29,10,3,48,2,101,193
TRIPURA,SIPAHIJALA,2012,23,24,3,42,1,155,248
TRIPURA,SOUTH,2012,30,16,5,46,0,89,186
TRIPURA,UNAKOTI,2012,26,9,2,26,2,92,157
TRIPURA,WEST,2012,50,30,12,66,2,172,332
TRIPURA,TOTAL,2012,229,114,37,314,7,858,1559
UTTAR PRADESH,AGRA,2012,58,255,88,134,0,320,855
UTTAR PRADESH,ALIGARH,2012,64,263,71,101,0,268,767
UTTAR PRADESH,ALLAHABAD,2012,52,202,63,79,0,247,643
UTTAR PRADESH,AMBEDKAR NAGAR,2012,12,61,9,10,0,75,167
UTTAR PRADESH,AURAIYA,2012,13,87,18,27,0,40,185
UTTAR PRADESH,AZAMGARH,2012,19,101,25,28,0,101,274
UTTAR PRADESH,BADAUN,2012,24,101,47,48,0,65,285
UTTAR PRADESH,BAGHPAT,2012,18,74,19,26,0,76,213
UTTAR PRADESH,BAHRAICH,2012,27,111,38,28,0,4,208
UTTAR PRADESH,BALLIA,2012,12,79,28,22,0,51,192
UTTAR PRADESH,BALRAMPUR,2012,12,53,5,17,0,4,91
UTTAR PRADESH,BANDA,2012,22,48,36,58,0,51,215
UTTAR PRADESH,BARABANKI,2012,31,120,31,39,0,114,335
UTTAR PRADESH,BAREILLY,2012,86,249,61,112,0,88,596
UTTAR PRADESH,BASTI,2012,7,55,21,17,0,69,169
UTTAR PRADESH,BHIM NAGAR,2012,23,91,27,30,0,64,235
UTTAR PRADESH,BIJNOR,2012,43,148,19,43,0,257,510
UTTAR PRADESH,BULANDSHAHAR,2012,46,164,48,63,2,304,627
UTTAR PRADESH,CHANDOLI,2012,11,32,14,23,0,37,117
UTTAR PRADESH,CHITRAKOOT DHAM,2012,31,27,22,35,0,23,138
UTTAR PRADESH,CSM NAGAR,2012,26,92,12,52,0,56,238
UTTAR PRADESH,DEORIA,2012,18,67,29,16,0,34,164
UTTAR PRADESH,ETAH,2012,22,99,38,62,0,82,303
UTTAR PRADESH,ETAWAH,2012,9,64,26,26,0,42,167
UTTAR PRADESH,FAIZABAD,2012,29,133,18,32,0,7,219
UTTAR PRADESH,FATEHGARH,2012,14,94,34,39,0,71,252
UTTAR PRADESH,FATEHPUR,2012,35,106,41,65,0,56,303
UTTAR PRADESH,FIROZABAD,2012,32,149,50,49,0,98,378
UTTAR PRADESH,G.R.P.,2012,3,7,2,36,0,0,48
UTTAR PRADESH,GAUTAMBUDH NAGAR,2012,19,115,17,50,0,142,343
UTTAR PRADESH,GHAZIABAD,2012,31,220,41,60,0,277,629
UTTAR PRADESH,GHAZIPUR,2012,9,53,32,16,0,60,170
UTTAR PRADESH,GONDA,2012,23,103,37,40,0,5,208
UTTAR PRADESH,GORAKHPUR,2012,52,207,53,56,0,180,548
UTTAR PRADESH,HAMIRPUR,2012,25,40,17,37,0,28,147
UTTAR PRADESH,HARDOI,2012,30,133,48,54,0,87,352
UTTAR PRADESH,HATHRAS,2012,17,71,18,39,0,91,236
UTTAR PRADESH,J.P.NAGAR,2012,34,58,19,31,0,82,224
UTTAR PRADESH,JALAUN,2012,15,57,40,32,0,47,191
UTTAR PRADESH,JAUNPUR,2012,15,111,51,18,0,55,250
UTTAR PRADESH,JHANSI,2012,19,63,33,34,0,53,202
UTTAR PRADESH,KANNAUJ,2012,12,75,27,36,0,106,256
UTTAR PRADESH,KANPUR NAGAR,2012,55,281,56,110,0,317,819
UTTAR PRADESH,KANSHIRAM NAGAR,2012,18,56,26,36,0,26,162
UTTAR PRADESH,KAUSHAMBI,2012,11,49,20,31,0,46,157
UTTAR PRADESH,KHIRI,2012,34,169,51,59,0,57,370
UTTAR PRADESH,KUSHI NAGAR,2012,30,94,28,22,0,28,202
UTTAR PRADESH,LALITPUR,2012,14,22,7,27,0,13,83
UTTAR PRADESH,LUCKNOW,2012,48,304,32,110,2,538,1034
UTTAR PRADESH,MAHARAJGANJ,2012,34,95,20,14,0,23,186
UTTAR PRADESH,MAHOBA,2012,16,43,20,48,0,24,151
UTTAR PRADESH,MAINPURI,2012,15,117,39,51,0,81,303
UTTAR PRADESH,MATHURA,2012,41,124,34,75,0,235,509
UTTAR PRADESH,MAU,2012,9,81,11,31,0,92,224
UTTAR PRADESH,MEERUT,2012,54,231,39,129,0,435,888
UTTAR PRADESH,MIRZAPUR,2012,4,6,24,3,0,29,66
UTTAR PRADESH,MORADABAD,2012,36,140,28,72,3,255,534
UTTAR PRADESH,MUZAFFARNAGAR,2012,27,177,16,38,0,225,483
UTTAR PRADESH,PANCHSHIL NAGAR,2012,15,51,17,22,0,56,161
UTTAR PRADESH,PILIBHIT,2012,10,62,25,15,0,79,191
UTTAR PRADESH,PRABUDDH NAGAR,2012,7,62,12,14,0,55,150
UTTAR PRADESH,PRATAPGARH,2012,36,109,24,53,0,72,294
UTTAR PRADESH,RAIBAREILLY,2012,36,91,23,46,0,50,246
UTTAR PRADESH,RAMABAI NAGAR,2012,18,74,28,32,0,77,229
UTTAR PRADESH,RAMPUR,2012,26,95,12,32,0,138,303
UTTAR PRADESH,SAHARANPUR,2012,18,91,27,17,1,113,267
UTTAR PRADESH,SANT KABIRNAGAR,2012,18,49,12,5,0,10,94
UTTAR PRADESH,SHAHJAHANPUR,2012,27,120,51,48,0,73,319
UTTAR PRADESH,SHRAWASTI,2012,22,40,18,20,0,1,101
UTTAR PRADESH,SIDHARTHNAGAR,2012,22,47,8,13,0,35,125
UTTAR PRADESH,SITAPUR,2012,49,224,45,94,0,125,537
UTTAR PRADESH,SONBHADRA,2012,21,28,17,18,0,21,105
UTTAR PRADESH,ST.RAVIDASNAGAR,2012,4,18,7,6,0,13,48
UTTAR PRADESH,SULTANPUR,2012,26,63,15,29,0,84,217
UTTAR PRADESH,UNNAO,2012,41,174,44,81,0,141,481
UTTAR PRADESH,VARANASI,2012,21,85,35,26,0,177,344
UTTAR PRADESH,TOTAL,2012,1963,7910,2244,3247,8,7661,23033
UTTARAKHAND,ALMORA,2012,5,0,2,5,5,5,22
UTTARAKHAND,BAGESHWAR,2012,8,1,4,5,0,2,20
UTTARAKHAND,CHAMOLI,2012,2,2,1,4,0,0,9
UTTARAKHAND,CHAMPAWAT,2012,3,0,1,4,0,0,8
UTTARAKHAND,DEHRADUN,2012,30,41,13,24,34,111,253
UTTARAKHAND,HARIDWAR,2012,47,73,10,38,17,89,274
UTTARAKHAND,NAINITAL,2012,16,29,10,11,9,22,97
UTTARAKHAND,PAURI GARHWAL,2012,2,10,2,1,3,2,20
UTTARAKHAND,PITHORAGARH,2012,1,1,2,2,1,2,9
UTTARAKHAND,RUDRA PRAYAG,2012,2,3,1,5,4,4,19
UTTARAKHAND,TEHRI GARHWAL,2012,1,3,3,1,0,0,8
UTTARAKHAND,UDHAMSINGH NAGAR,2012,30,91,22,38,0,128,309
UTTARAKHAND,UTTARKASHI,2012,1,2,0,1,0,3,7
UTTARAKHAND,TOTAL,2012,148,256,71,139,73,368,1055
WEST BENGAL,24 PARGANAS NORTH,2012,118,338,74,196,1,1860,2587
WEST BENGAL,24 PARGANAS SOUTH,2012,244,419,45,83,0,1666,2457
WEST BENGAL,ASANSOL,2012,36,49,15,31,4,240,375
WEST BENGAL,BANKURA,2012,35,80,26,90,3,221,455
WEST BENGAL,BDN CP,2012,13,0,9,58,8,320,408
WEST BENGAL,BIRBHUM,2012,49,62,23,87,0,245,466
WEST BENGAL,BKP CP,2012,36,201,20,88,2,989,1336
WEST BENGAL,BURDWAN,2012,58,65,55,145,0,224,547
WEST BENGAL,COOCHBEHAR,2012,92,169,25,117,8,539,950
WEST BENGAL,DAKSHIN DINAJPUR,2012,66,107,18,83,3,342,619
WEST BENGAL,DARJEELING,2012,10,39,2,52,4,106,213
WEST BENGAL,HOOGHLY,2012,68,145,32,86,5,1195,1531
WEST BENGAL,HOWRAH,2012,56,120,16,99,31,883,1205
WEST BENGAL,HOWRAH CITY,2012,28,135,15,199,71,550,998
WEST BENGAL,HOWRAH G.R.P.,2012,2,2,1,4,0,1,10
WEST BENGAL,JALPAIGURI,2012,163,279,17,179,0,1625,2263
WEST BENGAL,JHARGRAM,2012,21,21,6,28,0,47,123
WEST BENGAL,KHARAGPUR G.R.P.,2012,2,4,0,3,1,2,12
WEST BENGAL,KOLKATA,2012,68,210,19,486,377,865,2025
WEST BENGAL,MALDA,2012,158,189,7,177,0,660,1191
WEST BENGAL,MURSHIDABAD,2012,257,464,39,609,6,2831,4206
WEST BENGAL,NADIA,2012,174,374,46,56,11,1860,2521
WEST BENGAL,PASCHIM MIDNAPUR,2012,64,115,26,99,1,823,1128
WEST BENGAL,PURAB MIDNAPUR,2012,65,170,31,19,0,572,857
WEST BENGAL,PURULIA,2012,50,34,12,64,0,206,366
WEST BENGAL,SEALDAH G.R.P.,2012,0,5,1,14,2,0,22
WEST BENGAL,SILIGURI G.R.P.,2012,0,3,1,8,1,0,13
WEST BENGAL,SILIGURI_PC,2012,21,111,3,35,12,370,552
WEST BENGAL,UTTAR DINAJPUR,2012,92,258,9,150,5,623,1137
WEST BENGAL,TOTAL,2012,2046,4168,593,3345,556,19865,30573
A & N ISLANDS,CAR,2012,0,1,0,1,0,0,2
A & N ISLANDS,NORTH,2012,4,0,0,2,1,2,9
A & N ISLANDS,SOUTH,2012,8,6,2,14,3,3,36
A & N ISLANDS,TOTAL,2012,12,7,2,17,4,5,47
CHANDIGARH,CHANDIGARH,2012,27,66,5,45,25,73,241
CHANDIGARH,TOTAL,2012,27,66,5,45,25,73,241
D & N HAVELI,D and N HAVELI,2012,3,9,0,2,0,0,14
D & N HAVELI,TOTAL,2012,3,9,0,2,0,0,14
DAMAN & DIU,DAMAN,2012,5,0,0,0,0,1,6
DAMAN & DIU,DIU,2012,0,0,0,0,0,2,2
DAMAN & DIU,TOTAL,2012,5,0,0,0,0,3,8
DELHI,CAW,2012,0,0,0,0,0,178,178
DELHI,CENTRAL,2012,31,95,4,47,12,57,246
DELHI,CRIME BRANCH,2012,1,1,0,0,0,0,2
DELHI,DELHI UT TOTAL,2012,706,2160,134,727,208,1985,5920
DELHI,EAST,2012,90,251,7,96,26,202,672
DELHI,EOW,2012,0,0,0,0,0,0,0
DELHI,GRP(RLY),2012,4,12,1,12,6,0,35
DELHI,IGI AIRPORT,2012,0,0,0,6,0,0,6
DELHI,NEW DELHI,2012,5,13,0,29,7,4,58
DELHI,NORTH,2012,14,84,6,29,10,70,213
DELHI,NORTH-EAST,2012,78,263,25,69,9,293,737
DELHI,NORTH-WEST,2012,64,184,12,19,14,212,505
DELHI,OUTER,2012,67,317,15,79,18,244,740
DELHI,SOUTH,2012,70,134,17,59,36,68,384
DELHI,SOUTH-EAST,2012,116,306,11,160,43,123,759
DELHI,SOUTH-WEST,2012,87,244,18,69,21,207,646
DELHI,STF,2012,0,0,0,0,0,0,0
DELHI,WEST,2012,79,256,18,53,6,327,739
LAKSHADWEEP,LAKSHADWEEP,2012,0,0,0,1,0,1,2
LAKSHADWEEP,TOTAL,2012,0,0,0,1,0,1,2
PUDUCHERRY,KARAIKAL,2012,6,2,0,2,0,1,11
PUDUCHERRY,PUDUCHERRY,2012,7,14,0,7,2,5,35
PUDUCHERRY,TOTAL,2012,13,16,0,9,2,6,46
